CSASRDTNQPQHF	CASSRDGNQPQHF	global
CSASRDTNQPQHF	CASSRDRNQPQHF	global
CASSPEDTQYF	CASSPRDTQYF	global
CASSRQGGNEKLFF	CASSRTGGNEKLFF	global
CATSEPGTANQPQHF	CASSYPGTANQPQHF	global
CASSPDRAADTQYF	CASSPDRGADTQYF	global
CASRAGPSTDTQYF	CASRAGPGTDTQYF	global
CSARALAGGNTGELFF	CSARGLAGGNTGELFF	global
CASSPSTNYGYTF	CASSPTTNYGYTF	global
CASSAGADNEQFF	CATSDGADNEQFF	global
CSALLISGNTIYF	CAWTLISGNTIYF	global
CASSLAGSNTEAFF	CASSLAGGNTEAFF	global
CSASKETQYF	CASSQETQYF	global
CASSYGGYEQFF	CASSPGGYEQYF	global
CASSPIQGSRTEAFF	CASSPIQGSDSPLHF	local
CASSPIQGSRTEAFF	CASSPIQGSDSPLHF	local
CASSPIQGSRTEAFF	CASSPIQGINADTQYF	local
CASSPIQGSRTEAFF	CASSPIQGINADTQYF	local
CASSPIQGSRTEAFF	CASSPIQGGLILVEQFF	local
CASSPIQGSRTEAFF	CASSPIQGGLILVEQFF	local
CASLLGGTDTQYF	CSALVGGTDTQYF	global
CASLLGGTDTQYF	CASTLGGTDTQYF	global
CASSLAGGAGEQYF	CASSLAGGASEQFF	global
CASSPGGYGYTF	CASSPGGYEQYF	global
CASSVGSDAYNEQFF	CASSVGLDAYNEQFF	global
CASSVGSDAYNEQFF	CAWSVGSGAYNEQFF	global
CASSQGTYEQYF	CASSQGTHEQYF	global
CASSLKGVEQYF	CASSLKGAEAFF	global
CASSLKGVEQYF	CASSLKGDEQYF	global
CASSVDGATNEKLFF	CSASVFGATNEKLFF	global
CASSVDGATNEKLFF	CASSVQGATNEKLFF	global
CASSQGGNTEAFF	CASSVGGNTEAFF	global
CASSQGGNTEAFF	CASSQGRNTEAFF	global
CASSQGGNTEAFF	CASSPGGNTEAFF	global
CASSVGVWETQYF	CASSIGVWETQYF	global
CASSTGGSSTDTQYF	CASSFGGSSTDTQYF	global
CASKGRTYNEQFF	CASSYKGRTGELFF	local
CASKGRTYNEQFF	CASSKGRTDSDEQYF	local
CASKGRTYNEQFF	CASKGRTNYGYTF	local
CASKGRTYNEQFF	CSAKKGRTYEQYF	local
CASSLGTGANEQFF	CASSLGTGYNEQFF	global
CASSLGDTQYF	CASSLGETQYF	global
CASSLGDTQYF	CASSLRDTQYF	global
CASSPRSSYNEQFF	CASSPRGSYNEQFF	global
CASSPRSSYNEQFF	CASSSRSSYNEQFF	global
CASSPNLYEQFF	CASSPNAYEQYF	global
CASRGTTNTGELFF	CASRGTPNTGELFF	global
CASRGTTNTGELFF	CASRGGTNTGELFF	global
CASSLPAYEQYF	CASSLLAYEQYF	global
CSAPLGGSTDTQYF	CASSLGGSTDTQYF	global
CASSPDAGYEQYF	CSASPGAGYEQYF	global
CSASGQGAGELFF	CASSLQGAGEAFF	global
CATSPGSTDTQYF	CASSPGGTDTQYF	global
CASSLQQGAGYNEQFF	CASSLQQGADEQFF	local
CASSLQQGAGYNEQFF	CASSLQQGADEQFF	local
CASSLQQGAGYNEQFF	CASSLQQGADEQFF	local
CASSLQQGAGYNEQFF	CASSQDLQQGASKTQYF	local
CASSLQQGAGYNEQFF	CASSQDLQQGASKTQYF	local
CASSLQQGAGYNEQFF	CASSLQQGTYTF	local
CASSLQQGAGYNEQFF	CASSLQQGTYTF	local
CASSLQQGAGYNEQFF	CASSLQQGTYTF	local
CASSLQQGAGYNEQFF	CASSLQQGEYGYTF	local
CASSLQQGAGYNEQFF	CASSLQQGEYGYTF	local
CASSLQQGAGYNEQFF	CASSLQQGEYGYTF	local
CASRGPGNTEAFF	CASRGPLNTEAFF	global
CAVEGLAGGTDTQYF	CSSRGLAGGTDTQYF	global
CASSLSWQLAKNIQYF	CASSLSWQTTPYEQYF	local
CASSLSWQLAKNIQYF	CASSLSWQTLPYEQFF	local
CASSLSWQLAKNIQYF	CASSLSWQVVPYEQYF	local
CATRRGGHQNTGELFF	CASRVGGHQNTGELFF	global
CASSSGLGELFF	CASSSLLGELFF	global
CASSPRTSGSRYEQYF	CASSPRTSGSRDEQFF	global
CASSLDSYYGYTF	CASSLDSNYGYTF	global
CASSLSYEQYF	CASSLAYEQYF	global
CASSLSYEQYF	CASSISYEQYF	global
CASSLSYEQYF	CASSDSYEQYF	global
CASSYSGRDGYTF	CASSYRGRDGYTF	global
CASSERPLAVITDTQYF	CASSFSERPPYF	local
CASSERPLAVITDTQYF	CASSERPQGIGETQYF	local
CASSERPLAVITDTQYF	CASSERPKSSGANVLTF	local
CASSPRDTQYF	CASSLRDTQYF	global
CAFSGAGNTIYF	CAWSGPGNTIYF	global
CASSRDGNQPQHF	CASSRDRNQPQHF	global
CASSASGAKNTGELFF	CSARASGAKNTGELFF	global
CASSSHGGGEKLFF	CASSSTGGGEKLFF	global
CASSAVTDTQYF	CASSVVTDTQYF	global
CASSLAGGQYNEQFF	CASSLAGGRYNEQFF	global
CASSLGDTEAFF	CASSRGDTEAFF	global
CASSLGDTEAFF	CASSLGRTEAFF	global
CASSGYYEQYF	CASSSYYEQYF	global
CASSLEGAEAFF	CASSLKGAEAFF	global
CASSSYGGQETQYF	CASSSRGGQETQYF	global
CSASVFGATNEKLFF	CASSVQGATNEKLFF	global
CASSPGQGTDTQYF	CASSLGQGTDTQYF	global
CASSLRGAGANVLTF	CASSPRGAGANVLTF	global
CASSLQQGADEQFF	CASSQDLQQGASKTQYF	local
CASSLQQGADEQFF	CASSQDLQQGASKTQYF	local
CASSLQQGADEQFF	CASSLQQGTYTF	local
CASSLQQGADEQFF	CASSLQQGTYTF	local
CASSLQQGADEQFF	CASSLQQGTYTF	local
CASSLQQGADEQFF	CASSLQQGEYGYTF	local
CASSLQQGADEQFF	CASSLQQGEYGYTF	local
CASSLQQGADEQFF	CASSLQQGEYGYTF	local
CSARSGSSYNEQFF	CSARRGSSYNEQFF	global
CASSPGLNEQFF	CSASTGLNEQFF	global
CASEEANYGYTF	CAIREEANYGYTF	local
CASEEANYGYTF	CSVEEANEEYF	local
CASSPQSGANVLTF	CASSSQSGANVLTF	global
CASSPQSGANVLTF	CAWSPDSGANVLTF	global
CASSLGVNEQFF	CASSLEVNEQFF	global
CASSLGVNEQFF	CASSLGSNEQFF	global
CASRNTGELFF	CASTNTGELFF	global
CASSPDRGSNQPQHF	CASSPDRGGNQPQHF	global
CASSLSSGSNSPLHF	CASSYSSGSNSPLHF	global
CASSLAGGGTDTQYF	CSASLAGGHTDTQYF	global
CASSLAGGGTDTQYF	CASSLASGGTDTQYF	global
CASSLEGNTIYF	CASSLSGNTIYF	global
CASSLGQGTDTQYF	CASSLGQGSDTIYF	global
CASSQDLQQGASKTQYF	CASSLQQGTYTF	local
CASSQDLQQGASKTQYF	CASSLQQGTYTF	local
CASSQDLQQGASKTQYF	CASSLQQGEYGYTF	local
CASSQDLQQGASKTQYF	CASSLQQGEYGYTF	local
CSVGRDVANEQFF	CASGRDEANEQFF	global
CTHSGRGNEQYF	CSASGRNNEQFF	global
CASSSGAEAFF	CAISTGAEQYF	global
CATSDSRADEQFF	CASSLSRADEQYF	global
CSVGRGEYEQYF	CALGRGSYEQYF	global
CASSLGGANYGYTF	CASSLEGANYGYTF	global
CASRSGGWETQYF	CASSSGGWETQYF	global
CASSLSWQTTPYEQYF	CASSLSWQTLPYEQFF	global
CASSLSWQTTPYEQYF	CASSLSWQTLPYEQFF	local
CASSLSWQTTPYEQYF	CASSLSWQVVPYEQYF	local
CASSLRDEQYF	CASSLRDTQYF	global
CASSLTGGTDTQYF	CASSRTGGTDTQYF	global
CASSHGAGELFF	CASSAGAGEQFF	global
CASSLEGRYYGYTF	CASSLEGRDYGYTF	global
CASSTGQGGNQPQHF	CASSLGQGGNQPQHF	global
CASSFTDTQYF	CASSATDTQYF	global
CASSRSGNEQFF	CASSREGNEQFF	global
CASSYKGRTGELFF	CASSKGRTDSDEQYF	local
CASSYKGRTGELFF	CASKGRTNYGYTF	local
CASSYKGRTGELFF	CSAKKGRTYEQYF	local
CASSLKGAEAFF	CASSLKGDEQYF	global
CAWSVLRANEQYF	CAWSVLAANEQFF	global
CATSALAGGGYEQYF	CASSPLAGGGYEQYF	global
CASSAGATNEKLFF	CASSPGATNEKLFF	global
CASSLATGRETQYF	CASSLAQGRETQYF	global
CASSLGGLSGNTIYF	CASSKGGLSGNTIYF	global
CASSKGRTDSDEQYF	CASKGRTNYGYTF	local
CASSKGRTDSDEQYF	CSAKKGRTYEQYF	local
CASSLVGGNTEAFF	CASSLVGRNTEAFF	global
CASSLVGGNTEAFF	CASSLAGGNTEAFF	global
CASSSQSGANVLTF	CASSSNSGANVLTF	global
CASSVGGNTEAFF	CAWSVGLNTEAFF	global
CASSVGGNTEAFF	CASSPGGNTEAFF	global
CSVGGGTYEQYF	CSAGTGTYEQYF	global
CASSRGDTEAFF	CSASRGNTEAFF	global
CASSYSGDSTDTQYF	CSASASGDSTDTQYF	global
CASSLQQGTYTF	CASSLQQGEYGYTF	local
CASSLQQGTYTF	CASSLQQGEYGYTF	local
CASSLQQGTYTF	CASSLQQGEYGYTF	local
CASSRGSYEQYF	CALGRGSYEQYF	global
CASSRGSYEQYF	CATSRGSYGYTF	global
CAISEPGQGAYEQYF	CASSPPGQGAYEQYF	global
CASSPGQDTQYF	CAWSPMQDTIYF	global
CASSLEVNEQFF	CASSLEVGEAFF	global
CASSQGRNTEAFF	CASSIGRNTEAFF	global
CASRNNEQFF	CASSNNEQFF	global
CASSLTTGTNEKLFF	CASSLVTGTNEKLFF	global
CASSDNYGYTF	CASSSNYGYTF	global
CASSGRTDTQYF	CASSGPTDTQYF	global
CASSLGGRTGELFF	CASSLWGRTGELFF	global
CASSTGQGAKTQYF	CASSTGQGGKTQYF	global
CASSLEGGFTEAFF	CASSLEGGLTEAFF	global
CASSPGRNYEQYF	CASSPGQNYEQYF	global
CASSLEGRGRFF	CASSLEGGGYTF	global
CASSLRGWETQYF	CASSLSGWETQYF	global
CASSFSERPPYF	CASSERPQGIGETQYF	local
CASSFSERPPYF	CASSERPKSSGANVLTF	local
CASSLGGGYTF	CASSLVGGAFF	global
CAWSPDSGANVLTF	CASSHDSGANVLTF	global
CAWSPDSGANVLTF	CASSLDSGANVLTF	global
CASSPLLGNQPQHF	CASSPLTGNQPQHF	global
CASSLRADTQYF	CASSLNADTQYF	global
CSASRTSGTDTQYF	CASSRTGGTDTQYF	global
CASNRGNTEAFF	CSASRGNTEAFF	global
CASSHDSGANVLTF	CASSLDSGANVLTF	global
CSASQGSNQPQHF	CASSLGSNQPQHF	global
CASSRGNQPQHF	CASSKGNQPQHF	global
CAWSYRNTEAFF	CASSYRGTEAFF	global
CAWSTGAYEQYF	CASSAGAYEQYF	global
CASSLGGMNTEAFF	CASSLEGMNTEAFF	global
CASSLIGETQYF	CASSLRGETQYF	global
CASSPGTAYNEQFF	CASSPGLAYNEQFF	global
CASSPGTAYNEQFF	CASSPGTTYNEQFF	global
CASSYRGETQYF	CASSLRGETQYF	global
CASSQGSNEQFF	CASSLGSNEQFF	global
CASSPSYGYTF	CASSSSYGYTF	global
CASSESGGSSYNEQFF	CASSESGSSSYNEQFF	global
CASSLVGEQYF	CASSLVGGAFF	global
CASSISYEQYF	CASSDSYEQYF	global
CASSFDLSGNTIYF	CASSFDRSGNTIYF	global
CAWSVGLNTEAFF	CASSRGLNTEAFF	global
CAWSTGNEQYF	CSASPGNEQFF	global
CAWSTGNEQYF	CAISTGAEQYF	global
CASSSSTEAFF	CASSSSSEAFF	global
CASSVPGGETQYF	CASSSPGGETQYF	global
CASSYRGTEAFF	CASSLRGTEAFF	global
CASSFKGQDADTQYF	CASSFKGSQETQYF	local
CASSFKGQDADTQYF	CASSFKGGNIQYF	local
CASSFKGQDADTQYF	CASSFKGHSNRETEAFF	local
CASSFKGQDADTQYF	CASSFKGWAYSNQPQHF	local
CATGQSYEQYF	CSVGPSYEQYF	global
CATGQSYEQYF	CAIGQTYEQYF	global
CAWSTSGANVLTF	CASSESGANVLTF	global
CASKGRTNYGYTF	CSAKKGRTYEQYF	local
CASSLAELNTEAFF	CASSLARLNTEAFF	global
CASSRGLNTEAFF	CATSRQLNTEAFF	global
CASSEGNTEAFF	CSASRGNTEAFF	global
CASSLSWQTLPYEQFF	CASSLSWQVVPYEQYF	local
CASSFKGSQETQYF	CASSFKGGNIQYF	local
CASSFKGSQETQYF	CASSFKGHSNRETEAFF	local
CASSFKGSQETQYF	CASSFKGWAYSNQPQHF	local
CASSPPTGNYGYTF	CASSPRTGNYGYTF	global
CASSLWGTEAFF	CASSLRGTEAFF	global
CASSPIQGSDSPLHF	CASSPIQGINADTQYF	local
CASSPIQGSDSPLHF	CASSPIQGINADTQYF	local
CASSPIQGSDSPLHF	CASSPIQGGLILVEQFF	local
CASSPIQGSDSPLHF	CASSPIQGGLILVEQFF	local
CASSFKGGNIQYF	CASSFKGHSNRETEAFF	local
CASSFKGGNIQYF	CASSFKGWAYSNQPQHF	local
CASSQGQGMNTEAFF	CASSQGQGMNNEQFF	global
CASSPRAGSYNEQFF	CASSPRTGSYNEQFF	global
CASSERPQGIGETQYF	CASSERPKSSGANVLTF	local
CASSPGGNTEAFF	CAWSPGFNTEAFF	global
CASSLDSNYGYTF	CASSLDANYGYTF	global
CASSLRQGEAFF	CASSLRIGELFF	global
CASSAGAGEQFF	CASSAGSGELFF	global
CASSAGAGEQFF	CASSAGAYEQYF	global
CASSSSGGGTDTQYF	CASSQSGGGTDTQYF	global
CASSRQSNTEAFF	CATSRQLNTEAFF	global
CASSPGGYEQYF	CASSPGPYEQYF	global
CASSSIGLAADTQYF	CASSSFGLAADTQYF	global
CSARGLLGGTDTQYF	CSSRGLAGGTDTQYF	global
CASSSSYGYTF	CASSSNYGYTF	global
CASSDQYEQYF	CASSDSYEQYF	global
CASSPIQGINADTQYF	CASSPIQGGLILVEQFF	local
CASSPIQGINADTQYF	CASSPIQGGLILVEQFF	local
CASRGGGTEAFF	CASRLGGTEAFF	global
CASSLGVGNTEAFF	CASSLGRGNTEAFF	global
CASSVGAAPYEQYF	CASSVGAASYEQYF	global
CASSSGGSNEQYF	CASSSGSSNEQFF	global
CASSTGLGGYTF	CAISTGGGGYTF	global
CAIREEANYGYTF	CSVEEANEEYF	local
CASSFGQTHQPQHF	CASSFGQTNQPQHF	global
CASSFKGHSNRETEAFF	CASSFKGWAYSNQPQHF	local
CASSLDSGANVLTF	CASSLHSGANVLTF	global
CSARDRDYWNEQFF	CSARDRDYWNEQFF	singleton
CASSQRPGLAGGPTDTQYF	CASSQRPGLAGGPTDTQYF	singleton
CAWTSGGGKRQETQYF	CAWTSGGGKRQETQYF	singleton
CASSRRAGSTDTQYF	CASSRRAGSTDTQYF	singleton
CATSDFSSGVNTGELFF	CATSDFSSGVNTGELFF	singleton
CASSSGPTGELFF	CASSSGPTGELFF	singleton
CASSSYGNTEAFF	CASSSYGNTEAFF	singleton
CASSPGQGWDEQFF	CASSPGQGWDEQFF	singleton
CASMSRSGELFF	CASMSRSGELFF	singleton
CASRGQGAGAYEQYF	CASRGQGAGAYEQYF	singleton
CSVEDWGAQDLNEQFF	CSVEDWGAQDLNEQFF	singleton
CSARGGTGGGSLAKNIQYF	CSARGGTGGGSLAKNIQYF	singleton
CASSPRQGLYEQYF	CASSPRQGLYEQYF	singleton
CAWTYGAGVAYEQYF	CAWTYGAGVAYEQYF	singleton
CASRTGTGGADTQYF	CASRTGTGGADTQYF	singleton
CASSPIPNTRNQETQYF	CASSPIPNTRNQETQYF	singleton
CASSAGQDPYGYTF	CASSAGQDPYGYTF	singleton
CSAKTSLPSYEQYF	CSAKTSLPSYEQYF	singleton
CSASTQGGGLQPQHF	CSASTQGGGLQPQHF	singleton
CASSPTGTITEAFF	CASSPTGTITEAFF	singleton
CAGLAGGPGEQYF	CAGLAGGPGEQYF	singleton
CASSLWGGVNTEAFF	CASSLWGGVNTEAFF	singleton
CASSPGTPSTGELFF	CASSPGTPSTGELFF	singleton
CASSGRDSGANVLTF	CASSGRDSGANVLTF	singleton
CASRTGLAGEDTQYF	CASRTGLAGEDTQYF	singleton
CASSLHGKETQYF	CASSLHGKETQYF	singleton
CASSLQPGLAFYNEQFF	CASSLQPGLAFYNEQFF	singleton
CASSQGGDIQETQYF	CASSQGGDIQETQYF	singleton
CASSLELAITGADTQYF	CASSLELAITGADTQYF	singleton
CASNNRGLGGNTIYF	CASNNRGLGGNTIYF	singleton
CASSSHQGASYEQYF	CASSSHQGASYEQYF	singleton
CSARRGAAGTDTQYF	CSARRGAAGTDTQYF	singleton
CASSLPTRSETQYF	CASSLPTRSETQYF	singleton
CASSLYDNEQFF	CASSLYDNEQFF	singleton
CASSVGRDFNSPLHF	CASSVGRDFNSPLHF	singleton
CASSLGTGDLDTQYF	CASSLGTGDLDTQYF	singleton
CASSASRGGGRIEDTQYF	CASSASRGGGRIEDTQYF	singleton
CASGGDSEQFF	CASGGDSEQFF	singleton
CASSRIGDRGRSTEAFF	CASSRIGDRGRSTEAFF	singleton
CSAIQRSGTKLFF	CSAIQRSGTKLFF	singleton
CASSLTGGLFAEAFF	CASSLTGGLFAEAFF	singleton
CASSFRQVRTGEQYF	CASSFRQVRTGEQYF	singleton
CASSYSRLAGIADTQYF	CASSYSRLAGIADTQYF	singleton
CAIYSGALTDTQYF	CAIYSGALTDTQYF	singleton
CASKAGGYSPLHF	CASKAGGYSPLHF	singleton
CASSEARQGGQVGLAKNIQYF	CASSEARQGGQVGLAKNIQYF	singleton
CASSLVYGTLTEAFF	CASSLVYGTLTEAFF	singleton
CATTPGRLNTEAFF	CATTPGRLNTEAFF	singleton
CASSRPSGRARETQYF	CASSRPSGRARETQYF	singleton
CASSLHQGTAYEQYF	CASSLHQGTAYEQYF	singleton
CASSDPGPGNYGYTF	CASSDPGPGNYGYTF	singleton
CASSLSNYNEQFF	CASSLSNYNEQFF	singleton
CASSQKKLETQYF	CASSQKKLETQYF	singleton
CASSPHLVNEQFF	CASSPHLVNEQFF	singleton
CSARGVENSGELFF	CSARGVENSGELFF	singleton
CSAPLPFNPGAEAFF	CSAPLPFNPGAEAFF	singleton
CASSYDRGDQPQHF	CASSYDRGDQPQHF	singleton
CASSYPRPGTSTDTQYF	CASSYPRPGTSTDTQYF	singleton
CASSLGVAVETQYF	CASSLGVAVETQYF	singleton
CASRDRGGNTEAFF	CASRDRGGNTEAFF	singleton
CASSLAGTGGYGYTF	CASSLAGTGGYGYTF	singleton
CASRMDGTTYEQYF	CASRMDGTTYEQYF	singleton
CASSLDREVIDGYTF	CASSLDREVIDGYTF	singleton
CASSRGTSGTPSTDTQYF	CASSRGTSGTPSTDTQYF	singleton
CASSGGASSGETQYF	CASSGGASSGETQYF	singleton
CASSFGDRYTGELFF	CASSFGDRYTGELFF	singleton
CSVEWDTLYGYTF	CSVEWDTLYGYTF	singleton
CASTLEGSGGTEAFF	CASTLEGSGGTEAFF	singleton
CASSWGAGPNEQFF	CASSWGAGPNEQFF	singleton
CSVRTQGANTEAFF	CSVRTQGANTEAFF	singleton
CASRGSGGNNEQFF	CASRGSGGNNEQFF	singleton
CASSFRGAAGANVLTF	CASSFRGAAGANVLTF	singleton
CASSLQTQRGAKTQYF	CASSLQTQRGAKTQYF	singleton
CASSPTGGHGHGYTF	CASSPTGGHGHGYTF	singleton
CASSPRADNSNQPQHF	CASSPRADNSNQPQHF	singleton
CASTSGPFSTDTQYF	CASTSGPFSTDTQYF	singleton
CASSVVDLSDPANYGYTF	CASSVVDLSDPANYGYTF	singleton
CASSMVRGRLNTEAFF	CASSMVRGRLNTEAFF	singleton
CASSQKGDSEKLFF	CASSQKGDSEKLFF	singleton
CASSFGREEENTQYF	CASSFGREEENTQYF	singleton
CASSLGAADTQYF	CASSLGAADTQYF	singleton
CASSQQGVAETQYF	CASSQQGVAETQYF	singleton
CASSSQRGEQFF	CASSSQRGEQFF	singleton
CASSYLTGGFTEAFF	CASSYLTGGFTEAFF	singleton
CASSQAGRVDSGNTIYF	CASSQAGRVDSGNTIYF	singleton
CASSQDRVLGSYNEQFF	CASSQDRVLGSYNEQFF	singleton
CASSDYPEQYF	CASSDYPEQYF	singleton
CASSVRWGLYNEQFF	CASSVRWGLYNEQFF	singleton
CASSFSGSSYEQYF	CASSFSGSSYEQYF	singleton
CASSDSAKQGGGYTF	CASSDSAKQGGGYTF	singleton
CASSWAGGKDIQYF	CASSWAGGKDIQYF	singleton
CASSVLTPSYEQYF	CASSVLTPSYEQYF	singleton
CASSIWGAGTGANVLTF	CASSIWGAGTGANVLTF	singleton
CASGRNVGGTSNSGNTIYF	CASGRNVGGTSNSGNTIYF	singleton
CASSQGTGLGYEQYF	CASSQGTGLGYEQYF	singleton
CASSGNGAGQFF	CASSGNGAGQFF	singleton
CASSYYGGTIYF	CASSYYGGTIYF	singleton
CSVLTHNRATNYGYTF	CSVLTHNRATNYGYTF	singleton
CASSPTRATNQETQYF	CASSPTRATNQETQYF	singleton
CASSPITGPYEQYF	CASSPITGPYEQYF	singleton
CASSLYRGKGQPQHF	CASSLYRGKGQPQHF	singleton
CASSVHGSATYEQYF	CASSVHGSATYEQYF	singleton
CASSTAGTGSYNEQFF	CASSTAGTGSYNEQFF	singleton
CASSELGKGNGYTF	CASSELGKGNGYTF	singleton
CASRPPGNPYEQYF	CASRPPGNPYEQYF	singleton
CASSRFLWGVEGVGGELFF	CASSRFLWGVEGVGGELFF	singleton
CASSLAGLPYEQYF	CASSLAGLPYEQYF	singleton
CASSLGPSSRGGFF	CASSLGPSSRGGFF	singleton
CASSLGGFSSTDTQYF	CASSLGGFSSTDTQYF	singleton
CASSIGGQGTDTQYF	CASSIGGQGTDTQYF	singleton
CASSFFGSNEQFF	CASSFFGSNEQFF	singleton
CSARPPGATGWEQYF	CSARPPGATGWEQYF	singleton
CASNSREMRNSPLHF	CASNSREMRNSPLHF	singleton
CSANGQVPQAFF	CSANGQVPQAFF	singleton
CASSQAVWQLSYEQYF	CASSQAVWQLSYEQYF	singleton
CASSYSPHLDQPQHF	CASSYSPHLDQPQHF	singleton
CAWSVRQFSYEQYF	CAWSVRQFSYEQYF	singleton
CASSSGRNSPLHF	CASSSGRNSPLHF	singleton
CASGLLQNTEAFF	CASGLLQNTEAFF	singleton
CASSPRTMGRKSYEQYF	CASSPRTMGRKSYEQYF	singleton
CASSVSDRDGYGYTF	CASSVSDRDGYGYTF	singleton
CASSRRLVANEQFF	CASSRRLVANEQFF	singleton
CASSKGERGPGANVLTF	CASSKGERGPGANVLTF	singleton
CASSLIRLAEETQYF	CASSLIRLAEETQYF	singleton
CASSQDWDRGVFRETQYF	CASSQDWDRGVFRETQYF	singleton
CASSSTGAPYEQYF	CASSSTGAPYEQYF	singleton
CASSLEGGGAGSTDTQYF	CASSLEGGGAGSTDTQYF	singleton
CSASPAAANMNTGELFF	CSASPAAANMNTGELFF	singleton
CARSLRWLRVQPQHF	CARSLRWLRVQPQHF	singleton
CASSTGTTSSDTQYF	CASSTGTTSSDTQYF	singleton
CASSPSSWAETQYF	CASSPSSWAETQYF	singleton
CASSPGLAIEQYF	CASSPGLAIEQYF	singleton
CASSQESDLETQYF	CASSQESDLETQYF	singleton
CASSLGQGARYEQYF	CASSLGQGARYEQYF	singleton
CASSLERGSTGELFF	CASSLERGSTGELFF	singleton
CASSLTGGPTNEKLFF	CASSLTGGPTNEKLFF	singleton
CASSELGYTGELFF	CASSELGYTGELFF	singleton
CASSLRRGEAGGRQFF	CASSLRRGEAGGRQFF	singleton
CASSRTEGPAGELFF	CASSRTEGPAGELFF	singleton
CAWSPWGDQPQHF	CAWSPWGDQPQHF	singleton
CSVLGLAKNIQYF	CSVLGLAKNIQYF	singleton
CASSLEPTGTSYEQYF	CASSLEPTGTSYEQYF	singleton
CASSRRWNTEAFF	CASSRRWNTEAFF	singleton
CATSTGRRRVPPETQYF	CATSTGRRRVPPETQYF	singleton
CASSKSHLSSRGGGAQYF	CASSKSHLSSRGGGAQYF	singleton
CSVPGQKSKIEAFF	CSVPGQKSKIEAFF	singleton
CASSYGTGVIPYGYTF	CASSYGTGVIPYGYTF	singleton
CSVAGTAINGYTF	CSVAGTAINGYTF	singleton
CASSHGTLFF	CASSHGTLFF	singleton
CASSRKDGYTF	CASSRKDGYTF	singleton
CAWSRVAGVQETQYF	CAWSRVAGVQETQYF	singleton
CASSSTPSGTIYF	CASSSTPSGTIYF	singleton
CASSYDSGTGFNNEQFF	CASSYDSGTGFNNEQFF	singleton
CASRGEPNNSPLHF	CASRGEPNNSPLHF	singleton
CASRTGQNTGELFF	CASRTGQNTGELFF	singleton
CASSQEIGDSNQPQHF	CASSQEIGDSNQPQHF	singleton
CASSQALRVSQYF	CASSQALRVSQYF	singleton
CASSYGGGAGNGYTF	CASSYGGGAGNGYTF	singleton
CASTQGPGGFYEQYF	CASTQGPGGFYEQYF	singleton
CASSLVPGTGRGDTQYF	CASSLVPGTGRGDTQYF	singleton
CSVDGVVDTEAFF	CSVDGVVDTEAFF	singleton
CASSVGSGGAVDTQYF	CASSVGSGGAVDTQYF	singleton
CASSPARRVGTDTQYF	CASSPARRVGTDTQYF	singleton
CASSFLFYEQYF	CASSFLFYEQYF	singleton
CASSSPSDRGYEQYF	CASSSPSDRGYEQYF	singleton
CASSLTGSFYNEQFF	CASSLTGSFYNEQFF	singleton
CASSSLFNEQFF	CASSSLFNEQFF	singleton
CSAPDRDYEQYF	CSAPDRDYEQYF	singleton
CAWGRGQGVAETQYF	CAWGRGQGVAETQYF	singleton
CASSLYGSRREQYF	CASSLYGSRREQYF	singleton
CSARDRGPPYF	CSARDRGPPYF	singleton
CASSLYNLIQDTQYF	CASSLYNLIQDTQYF	singleton
CASSPWDPTDTQYF	CASSPWDPTDTQYF	singleton
CASGGLQSYGANVLTF	CASGGLQSYGANVLTF	singleton
CASSQDRISTNSPLHF	CASSQDRISTNSPLHF	singleton
CASSQTERRGSGYGYTF	CASSQTERRGSGYGYTF	singleton
CSARGSELLAGVKPDTQYF	CSARGSELLAGVKPDTQYF	singleton
CSARYRASRYGYTF	CSARYRASRYGYTF	singleton
CASTFGTSGGDTQYF	CASTFGTSGGDTQYF	singleton
CASSRLGIYEQYF	CASSRLGIYEQYF	singleton
CAGSGTGGGTQYF	CAGSGTGGGTQYF	singleton
CASSPQTELVETQYF	CASSPQTELVETQYF	singleton
CASSPRLMQGGNTEAFF	CASSPRLMQGGNTEAFF	singleton
CASSPWTSGKRTDTQYF	CASSPWTSGKRTDTQYF	singleton
CASSLADANTEAFF	CASSLADANTEAFF	singleton
CSAGGGREETQYF	CSAGGGREETQYF	singleton
CASSPGYATNEKLFF	CASSPGYATNEKLFF	singleton
CASSQAGLAGGPVGELFF	CASSQAGLAGGPVGELFF	singleton
CSASIARGTETQYF	CSASIARGTETQYF	singleton
CASSPGTSLNTGELFF	CASSPGTSLNTGELFF	singleton
CASSTGTSGSDTQYF	CASSTGTSGSDTQYF	singleton
CASSYALEAGETQYF	CASSYALEAGETQYF	singleton
CASSYMDLNGYTF	CASSYMDLNGYTF	singleton
CASDSGGLAKNIQYF	CASDSGGLAKNIQYF	singleton
CASSNDILGQSLLGYTF	CASSNDILGQSLLGYTF	singleton
CSVDLTRTGTQYF	CSVDLTRTGTQYF	singleton
CAISEYGTGVDEQFF	CAISEYGTGVDEQFF	singleton
CASSYTGPQETQYF	CASSYTGPQETQYF	singleton
CSAREGGLETQYF	CSAREGGLETQYF	singleton
CASSSGQGVYGYTF	CASSSGQGVYGYTF	singleton
CSAGTEQETQYF	CSAGTEQETQYF	singleton
CASSDFGQSFRPQHF	CASSDFGQSFRPQHF	singleton
CAGAVAGGPGNEQFF	CAGAVAGGPGNEQFF	singleton
CGIYRGETQYF	CGIYRGETQYF	singleton
CSARQWGPSTDTQYF	CSARQWGPSTDTQYF	singleton
CAWSGMEGFDTQYF	CAWSGMEGFDTQYF	singleton
CASSQNRALTDTQYF	CASSQNRALTDTQYF	singleton
CAISGRDNSPLHF	CAISGRDNSPLHF	singleton
CASRTYPRDRHYF	CASRTYPRDRHYF	singleton
CASSYQTGASLYGYTF	CASSYQTGASLYGYTF	singleton
CSATLSGDYGYTF	CSATLSGDYGYTF	singleton
CSAIRGADQPQHF	CSAIRGADQPQHF	singleton
CASSSDGQAHRTPQETQYF	CASSSDGQAHRTPQETQYF	singleton
CSVGAGRYQPQHF	CSVGAGRYQPQHF	singleton
CASSPQSLGNTEAFF	CASSPQSLGNTEAFF	singleton
CASSDWQYGYTF	CASSDWQYGYTF	singleton
CASSENVPGGRPLHF	CASSENVPGGRPLHF	singleton
CASSPLIIGTEAFF	CASSPLIIGTEAFF	singleton
CASRPMLGQVTEKLFF	CASRPMLGQVTEKLFF	singleton
CASSPEGGNIQYF	CASSPEGGNIQYF	singleton
CASSYGGVTDTQYF	CASSYGGVTDTQYF	singleton
CSVSTGVGQPQHF	CSVSTGVGQPQHF	singleton
CASSHRTGSGNEQFF	CASSHRTGSGNEQFF	singleton
CASITPGGRQYF	CASITPGGRQYF	singleton
CASSETSGSYYEQYF	CASSETSGSYYEQYF	singleton
CASSFSLHF	CASSFSLHF	singleton
CASSFTGTVNTEAFF	CASSFTGTVNTEAFF	singleton
CAIENALNTEAFF	CAIENALNTEAFF	singleton
CASSWGYYEQYF	CASSWGYYEQYF	singleton
CASNNRDRGGGYTF	CASNNRDRGGGYTF	singleton
CASSPITGPPGEQYF	CASSPITGPPGEQYF	singleton
CASSSYINREGTEAFF	CASSSYINREGTEAFF	singleton
CASSSGGQTYEQYF	CASSSGGQTYEQYF	singleton
CASRWTDTQYF	CASRWTDTQYF	singleton
CASSVGGTPGNTIYF	CASSVGGTPGNTIYF	singleton
CASSPGTRVYNEQFF	CASSPGTRVYNEQFF	singleton
CASSDTKLNYGYTF	CASSDTKLNYGYTF	singleton
CASSSGSRMNPFYEQYF	CASSSGSRMNPFYEQYF	singleton
CASSAGQGGNEQFF	CASSAGQGGNEQFF	singleton
CASSAMGAMNTEAFF	CASSAMGAMNTEAFF	singleton
CASKVGWQGGEQYF	CASKVGWQGGEQYF	singleton
CASSSSGGASEQFF	CASSSSGGASEQFF	singleton
CAWSVHPNYEQYF	CAWSVHPNYEQYF	singleton
CASRTGSSLEKLFF	CASRTGSSLEKLFF	singleton
CASSQDGDGGSNIQYF	CASSQDGDGGSNIQYF	singleton
CASSDPGHALHF	CASSDPGHALHF	singleton
CARQGQETQYF	CARQGQETQYF	singleton
CASSIEGRSRANYGYTF	CASSIEGRSRANYGYTF	singleton
CASSYDEGMETQYF	CASSYDEGMETQYF	singleton
CASSLVETDTEAFF	CASSLVETDTEAFF	singleton
CASSHVGWSYEQYF	CASSHVGWSYEQYF	singleton
CAWSGRQGNQPQHF	CAWSGRQGNQPQHF	singleton
CASSHRGTVNSNQPQHF	CASSHRGTVNSNQPQHF	singleton
CASFPDGAYEQYF	CASFPDGAYEQYF	singleton
CAITRSLYNSPLHF	CAITRSLYNSPLHF	singleton
CASGFLGGDYGYTF	CASGFLGGDYGYTF	singleton
CASSQSSGYTF	CASSQSSGYTF	singleton
CASRPTASYEQYF	CASRPTASYEQYF	singleton
CASSFQWTGSGANVLTF	CASSFQWTGSGANVLTF	singleton
CAISAGTGVNSGNTIYF	CAISAGTGVNSGNTIYF	singleton
CASSSPSVLSYNEQFF	CASSSPSVLSYNEQFF	singleton
CSVPDRANTGELFF	CSVPDRANTGELFF	singleton
CASSLEGLRGQPQHF	CASSLEGLRGQPQHF	singleton
CASSADTNTEAFF	CASSADTNTEAFF	singleton
CASSRGLAGGVYEQYF	CASSRGLAGGVYEQYF	singleton
CASSTRRASGGASTDTQYF	CASSTRRASGGASTDTQYF	singleton
CASSPPTGNAEAFF	CASSPPTGNAEAFF	singleton
CASSSTPQTSKYEQYF	CASSSTPQTSKYEQYF	singleton
CASSSRAGHQPQHF	CASSSRAGHQPQHF	singleton
CASTITGGVNGELFF	CASTITGGVNGELFF	singleton
CSARVGGRYNEQFF	CSARVGGRYNEQFF	singleton
CASSPPHRVRSNQPQHF	CASSPPHRVRSNQPQHF	singleton
CASSFNPGQYEQYF	CASSFNPGQYEQYF	singleton
CAWGVSYNEQFF	CAWGVSYNEQFF	singleton
CASSLHGQSYEQYF	CASSLHGQSYEQYF	singleton
CASSSPRNPAEQFF	CASSSPRNPAEQFF	singleton
CASTSGSAQKTQYF	CASTSGSAQKTQYF	singleton
CASSQDRTSGGLNEQFF	CASSQDRTSGGLNEQFF	singleton
CASSPQWGTNTEAFF	CASSPQWGTNTEAFF	singleton
CASVPITYMNTEAFF	CASVPITYMNTEAFF	singleton
CAGGGEGTEAFF	CAGGGEGTEAFF	singleton
CASSPLWNRQASNYGYTF	CASSPLWNRQASNYGYTF	singleton
CAIRRTGTAGANVLTF	CAIRRTGTAGANVLTF	singleton
CASRLTTDHGYTF	CASRLTTDHGYTF	singleton
CASSYRDSRYEQYF	CASSYRDSRYEQYF	singleton
CATSDPKTGGQTQYF	CATSDPKTGGQTQYF	singleton
CASSLGLADETQYF	CASSLGLADETQYF	singleton
CASSMGFGAQETQYF	CASSMGFGAQETQYF	singleton
CASTKGLGRETQYF	CASTKGLGRETQYF	singleton
CASSSWTGPGSQPQHF	CASSSWTGPGSQPQHF	singleton
CASSPAGGKEAFF	CASSPAGGKEAFF	singleton
CASSPPGTGANNSPLHF	CASSPPGTGANNSPLHF	singleton
CASSSGLASSVGYTQYF	CASSSGLASSVGYTQYF	singleton
CASSLGDDQPQHF	CASSLGDDQPQHF	singleton
CSVVGLYEQYF	CSVVGLYEQYF	singleton
CASSLRLAGLYEQYF	CASSLRLAGLYEQYF	singleton
CASSVDQRNSPLHF	CASSVDQRNSPLHF	singleton
CASSVEGGRNSPLHF	CASSVEGGRNSPLHF	singleton
CASSVGASGTYEQYF	CASSVGASGTYEQYF	singleton
CASSLLAGVAYNEQFF	CASSLLAGVAYNEQFF	singleton
CASSTGPNTEAFF	CASSTGPNTEAFF	singleton
CASIPDGPRGNQPQHF	CASIPDGPRGNQPQHF	singleton
CASSESPGKAFF	CASSESPGKAFF	singleton
CASSPWGVGTYEQYF	CASSPWGVGTYEQYF	singleton
CASSPGQRTYSNQPQHF	CASSPGQRTYSNQPQHF	singleton
CARGEGYFPTDTQYF	CARGEGYFPTDTQYF	singleton
CASRGPSEGGHNEQFF	CASRGPSEGGHNEQFF	singleton
CAISESRLARTNEQFF	CAISESRLARTNEQFF	singleton
CARTGFLTPHGYTF	CARTGFLTPHGYTF	singleton
CASSVDPTSGLYNEQFF	CASSVDPTSGLYNEQFF	singleton
CASKSGRGSYNEQFF	CASKSGRGSYNEQFF	singleton
CATNLGTSGTYNEQFF	CATNLGTSGTYNEQFF	singleton
CASSVGTAQTYGNQPQHF	CASSVGTAQTYGNQPQHF	singleton
CATKDSEGGAGTQYF	CATKDSEGGAGTQYF	singleton
CASSLQGSTGELFF	CASSLQGSTGELFF	singleton
CASSEEVILSSYNSPLHF	CASSEEVILSSYNSPLHF	singleton
CASSYSGGIGNEQFF	CASSYSGGIGNEQFF	singleton
CASSAGSPTEAFF	CASSAGSPTEAFF	singleton
CASSAPTGGVNQPQHF	CASSAPTGGVNQPQHF	singleton
CASSLRPSGETQYF	CASSLRPSGETQYF	singleton
CASSQDRRGQRVTQYF	CASSQDRRGQRVTQYF	singleton
CASSSGRSSGEGIAGYTF	CASSSGRSSGEGIAGYTF	singleton
CASSLGRGMGYEQYF	CASSLGRGMGYEQYF	singleton
CASSPPGSQEQYF	CASSPPGSQEQYF	singleton
CASSPGEWLNSYTF	CASSPGEWLNSYTF	singleton
CASSLGWGELFF	CASSLGWGELFF	singleton
CASRDGRDGSTSGANVLTF	CASRDGRDGSTSGANVLTF	singleton
CAWKWGEQYF	CAWKWGEQYF	singleton
CASSQGSGSSYEQYF	CASSQGSGSSYEQYF	singleton
CASSPGATKGETQYF	CASSPGATKGETQYF	singleton
CASSDSVGTDTQYF	CASSDSVGTDTQYF	singleton
CASSVKQGARETQYF	CASSVKQGARETQYF	singleton
CASSLLLAGTEQFF	CASSLLLAGTEQFF	singleton
CASRPTVFEWFF	CASRPTVFEWFF	singleton
CASSQRQTRRTGELFF	CASSQRQTRRTGELFF	singleton
CASSLVQGMNTEAFF	CASSLVQGMNTEAFF	singleton
CSAEVRTRALNEQFF	CSAEVRTRALNEQFF	singleton
CASSWDSAISPLHF	CASSWDSAISPLHF	singleton
CASSFRDGGTQYF	CASSFRDGGTQYF	singleton
CASSRWGTTGELFF	CASSRWGTTGELFF	singleton
CASSERVGTEAFF	CASSERVGTEAFF	singleton
CSAIKQGASYEQYF	CSAIKQGASYEQYF	singleton
CASSLGQRHTYNEQFF	CASSLGQRHTYNEQFF	singleton
CASSLSGQGEQYF	CASSLSGQGEQYF	singleton
CASSLGAQNTEAFF	CASSLGAQNTEAFF	singleton
CATSPGTGTGANVLTF	CATSPGTGTGANVLTF	singleton
CATSRDLSSGRIQYF	CATSRDLSSGRIQYF	singleton
CASSLDPSGPNTGELFF	CASSLDPSGPNTGELFF	singleton
CASSETGLSNQPQHF	CASSETGLSNQPQHF	singleton
CSARALAGGSGELFF	CSARALAGGSGELFF	singleton
CASSHRLREGGYTF	CASSHRLREGGYTF	singleton
CASSIGWTTDTQYF	CASSIGWTTDTQYF	singleton
CASSEFRSYEQYF	CASSEFRSYEQYF	singleton
CASSLDRKYSGNTIYF	CASSLDRKYSGNTIYF	singleton
CASTAGAREQYF	CASTAGAREQYF	singleton
CASSLAPGPGNNYGYTF	CASSLAPGPGNNYGYTF	singleton
CASSYDQGANTGELFF	CASSYDQGANTGELFF	singleton
CSAREPAGGGETQYF	CSAREPAGGGETQYF	singleton
CASSQLTPAGSMGQYF	CASSQLTPAGSMGQYF	singleton
CASSFGGSQPQHF	CASSFGGSQPQHF	singleton
CASSLPGGTQYF	CASSLPGGTQYF	singleton
CASRNRDRGSTEAFF	CASRNRDRGSTEAFF	singleton
CASSTSGGRYEQYF	CASSTSGGRYEQYF	singleton
CSVALATGTGNQPQHF	CSVALATGTGNQPQHF	singleton
CAITRQGSTEAFF	CAITRQGSTEAFF	singleton
CATAGAYEQYF	CATAGAYEQYF	singleton
CASGSRDRVNEQYF	CASGSRDRVNEQYF	singleton
CASSLVPLGAGGTDTQYF	CASSLVPLGAGGTDTQYF	singleton
CASSLDPPGELFF	CASSLDPPGELFF	singleton
CASSLGLAGGPNTDTQYF	CASSLGLAGGPNTDTQYF	singleton
CASSVGDGTEAFF	CASSVGDGTEAFF	singleton
CASSRPGQGGTGVANEQFF	CASSRPGQGGTGVANEQFF	singleton
CASSLARGGLANTGELFF	CASSLARGGLANTGELFF	singleton
CASSAGGTGPYEQYF	CASSAGGTGPYEQYF	singleton
CASSYGGRVTDTQYF	CASSYGGRVTDTQYF	singleton
CASSILGGHTDTQYF	CASSILGGHTDTQYF	singleton
CASSRQPRTSNQPQHF	CASSRQPRTSNQPQHF	singleton
CASSAGATSGNTIYF	CASSAGATSGNTIYF	singleton
CATSDSRRADTQYF	CATSDSRRADTQYF	singleton
CASSPFRGTGELFF	CASSPFRGTGELFF	singleton
CASGEHPISEQYF	CASGEHPISEQYF	singleton
CASREQVNTEAFF	CASREQVNTEAFF	singleton
CASSPSGGQEGRQYF	CASSPSGGQEGRQYF	singleton
CASSMPTGNTGELFF	CASSMPTGNTGELFF	singleton
CSARTLGTDTQYF	CSARTLGTDTQYF	singleton
CASSSGERVKPQHF	CASSSGERVKPQHF	singleton
CASSQDRRDVSGNTIYF	CASSQDRRDVSGNTIYF	singleton
CASSLALGQSYNEQFF	CASSLALGQSYNEQFF	singleton
CASSFLGAAGDEQFF	CASSFLGAAGDEQFF	singleton
CASSYSLWETQYF	CASSYSLWETQYF	singleton
CASSLAKKNTEAFF	CASSLAKKNTEAFF	singleton
CASSPPARANYGYTF	CASSPPARANYGYTF	singleton
CASSLLLAGTDTQYF	CASSLLLAGTDTQYF	singleton
CSARVAGDYNEQFF	CSARVAGDYNEQFF	singleton
CASSLEVGQFF	CASSLEVGQFF	singleton
CASSDSSRQYF	CASSDSSRQYF	singleton
CASSGQHEYGYTF	CASSGQHEYGYTF	singleton
CASSQNRPHESGELFF	CASSQNRPHESGELFF	singleton
CASSYGKNTGELFF	CASSYGKNTGELFF	singleton
CATSGSGTTEAFF	CATSGSGTTEAFF	singleton
CASSFRGVYEQYF	CASSFRGVYEQYF	singleton
CASSMGLLNEQYF	CASSMGLLNEQYF	singleton
CASSVDSGTYSEQFF	CASSVDSGTYSEQFF	singleton
CATSARLRANVLTF	CATSARLRANVLTF	singleton
CASSLAPGQAIGNEKLFF	CASSLAPGQAIGNEKLFF	singleton
CASTLLGGDSQPQHF	CASTLLGGDSQPQHF	singleton
CASSVGGTYGTEAFF	CASSVGGTYGTEAFF	singleton
CASRADEQYF	CASRADEQYF	singleton
CASSPGNWNQPQHF	CASSPGNWNQPQHF	singleton
CASGRFNSPLHF	CASGRFNSPLHF	singleton
CASTSVGGLSTDTQYF	CASTSVGGLSTDTQYF	singleton
CASSQEGRGQAFF	CASSQEGRGQAFF	singleton
CASKGRSQTDTQYF	CASKGRSQTDTQYF	singleton
CASNFDRAGDGYTF	CASNFDRAGDGYTF	singleton
CASSLNRGAGQPQHF	CASSLNRGAGQPQHF	singleton
CASRGRGGYTF	CASRGRGGYTF	singleton
CASSPPTGARYF	CASSPPTGARYF	singleton
CASSVELASGNTIYF	CASSVELASGNTIYF	singleton
CASSGGANMNTEAFF	CASSGGANMNTEAFF	singleton
CSARDNSGNTIYF	CSARDNSGNTIYF	singleton
CASSLSQGGVYEQYF	CASSLSQGGVYEQYF	singleton
CASSSGLPTDTQYF	CASSSGLPTDTQYF	singleton
CASSLWGLDQETQYF	CASSLWGLDQETQYF	singleton
CVTQGGDNEQFF	CVTQGGDNEQFF	singleton
CASSVWTGETQYF	CASSVWTGETQYF	singleton
CSAGTSAGTEAFF	CSAGTSAGTEAFF	singleton
CASSQDGGYEQYF	CASSQDGGYEQYF	singleton
CAWSVSLAGTDTQYF	CAWSVSLAGTDTQYF	singleton
CASSLEGGGYNEKLFF	CASSLEGGGYNEKLFF	singleton
CAWTHAVSYNEQFF	CAWTHAVSYNEQFF	singleton
CASSIDRGRAQVRTGELFF	CASSIDRGRAQVRTGELFF	singleton
CASSSGDGTGVEQYF	CASSSGDGTGVEQYF	singleton
CAISELNEQYF	CAISELNEQYF	singleton
CASKEGINEKLFF	CASKEGINEKLFF	singleton
CASSLRPGGTGAQSYTF	CASSLRPGGTGAQSYTF	singleton
CAWSEGESSYNEQFF	CAWSEGESSYNEQFF	singleton
CSARGDRDAFF	CSARGDRDAFF	singleton
CASGLEAGGEQYF	CASGLEAGGEQYF	singleton
CASSLGLAGGLRTQYF	CASSLGLAGGLRTQYF	singleton
CASSSSGSSYNEQFF	CASSSSGSSYNEQFF	singleton
CASSLDPAGPTPIF	CASSLDPAGPTPIF	singleton
CASSYGTGGQPQHF	CASSYGTGGQPQHF	singleton
CASSSNEDTGELFF	CASSSNEDTGELFF	singleton
CSADKTGTHGYTF	CSADKTGTHGYTF	singleton
CAITSGYNEQFF	CAITSGYNEQFF	singleton
CASAYKDTEAFF	CASAYKDTEAFF	singleton
CASTEDRVADTQYF	CASTEDRVADTQYF	singleton
CASSLSATTDTQYF	CASSLSATTDTQYF	singleton
CSASRDRGPYEQYF	CSASRDRGPYEQYF	singleton
CASSLGAGGGGETQYF	CASSLGAGGGGETQYF	singleton
CASSYDRRQARDSYNSPLHF	CASSYDRRQARDSYNSPLHF	singleton
CASSPPSGRATGELFF	CASSPPSGRATGELFF	singleton
CASSSGQRSLGANVLTF	CASSSGQRSLGANVLTF	singleton
CSARQTENTEAFF	CSARQTENTEAFF	singleton
CASSLDMIREQYF	CASSLDMIREQYF	singleton
CRAETSNYGYTF	CRAETSNYGYTF	singleton
CASSPPGQAGRIQYF	CASSPPGQAGRIQYF	singleton
CASSLEGRGSYNEQFF	CASSLEGRGSYNEQFF	singleton
CASASGTVNTGELFF	CASASGTVNTGELFF	singleton
CASSQTVVPYNEQFF	CASSQTVVPYNEQFF	singleton
CASSYLGGLETQYF	CASSYLGGLETQYF	singleton
CASSFSVGADTQYF	CASSFSVGADTQYF	singleton
CASSYGEGNLLGDEQFF	CASSYGEGNLLGDEQFF	singleton
CASKLGPTADTQYF	CASKLGPTADTQYF	singleton
CASSSLRLAGVEEQYF	CASSSLRLAGVEEQYF	singleton
CASSPSSGGESSYNEQFF	CASSPSSGGESSYNEQFF	singleton
CASTRLAKNNEQFF	CASTRLAKNNEQFF	singleton
CSARDGVGQFF	CSARDGVGQFF	singleton
CAWSPGTAFGEQYF	CAWSPGTAFGEQYF	singleton
CASSLEGRGSEQYF	CASSLEGRGSEQYF	singleton
CASGSLFGGGITEAFF	CASGSLFGGGITEAFF	singleton
CASTLTGDEQYF	CASTLTGDEQYF	singleton
CASSPPGQRSYNEQFF	CASSPPGQRSYNEQFF	singleton
CASSQGQAIGSGANVLTF	CASSQGQAIGSGANVLTF	singleton
CATSIEGPTYNEQFF	CATSIEGPTYNEQFF	singleton
CASSFAGGGEKLFF	CASSFAGGGEKLFF	singleton
CASSEPGTSGRACEQYF	CASSEPGTSGRACEQYF	singleton
CAWTGTGHTDTQYF	CAWTGTGHTDTQYF	singleton
CASSAAGGPRTDTQYF	CASSAAGGPRTDTQYF	singleton
CASSTPTGGSEKLFF	CASSTPTGGSEKLFF	singleton
CASSYSPYRWAQETYEQYF	CASSYSPYRWAQETYEQYF	singleton
CASSLTEFQANYGYTF	CASSLTEFQANYGYTF	singleton
CASSPGPQGVYNEQFF	CASSPGPQGVYNEQFF	singleton
CASSFGRYSTDTQYF	CASSFGRYSTDTQYF	singleton
CASSLGLGNTGELFF	CASSLGLGNTGELFF	singleton
CASSFEASPLHF	CASSFEASPLHF	singleton
CASSPTPWNLQGSTDTQYF	CASSPTPWNLQGSTDTQYF	singleton
CASSTTQGARGYTF	CASSTTQGARGYTF	singleton
CAEGENTEAFF	CAEGENTEAFF	singleton
CASSQDRASANNEQFF	CASSQDRASANNEQFF	singleton
CASSLDPRGMGVFF	CASSLDPRGMGVFF	singleton
CATRVRGDGNTIYF	CATRVRGDGNTIYF	singleton
CASSTPGTKGKNEQYF	CASSTPGTKGKNEQYF	singleton
CASTPQGDPNQPQHF	CASTPQGDPNQPQHF	singleton
CSASDRVTEAFF	CSASDRVTEAFF	singleton
CASSWGDSGRAYEQYF	CASSWGDSGRAYEQYF	singleton
CASSSQMSNQPQHF	CASSSQMSNQPQHF	singleton
CASSLGGTSDSYEQYF	CASSLGGTSDSYEQYF	singleton
CATSRDVTDHINYGYTF	CATSRDVTDHINYGYTF	singleton
CASSFEQGCEQYF	CASSFEQGCEQYF	singleton
CAWCPGTGIYEQYF	CAWCPGTGIYEQYF	singleton
CASADRDHEQYF	CASADRDHEQYF	singleton
CASNADGRDEKLFF	CASNADGRDEKLFF	singleton
CASSLAGLAGIEQFF	CASSLAGLAGIEQFF	singleton
CASGLGGDTEAFF	CASGLGGDTEAFF	singleton
CASSLGWRDGTNEQFF	CASSLGWRDGTNEQFF	singleton
CAWRPGQSLNEKLFF	CAWRPGQSLNEKLFF	singleton
CSAFSPDISTDTQYF	CSAFSPDISTDTQYF	singleton
CASLRGLGQRAGTDTQYF	CASLRGLGQRAGTDTQYF	singleton
CASSLHAGVSNQPQHF	CASSLHAGVSNQPQHF	singleton
CASSAAGGLGTEAFF	CASSAAGGLGTEAFF	singleton
CSAPDATRTNEKLFF	CSAPDATRTNEKLFF	singleton
CASSYAGTLGEQYF	CASSYAGTLGEQYF	singleton
CASSQVRGRDNYGYTF	CASSQVRGRDNYGYTF	singleton
CSAPHGQGRFEAFF	CSAPHGQGRFEAFF	singleton
CSAPDRGTRNTIYF	CSAPDRGTRNTIYF	singleton
CASGLVRFGMGGSNQPQHF	CASGLVRFGMGGSNQPQHF	singleton
CASSAAGEGEAFF	CASSAAGEGEAFF	singleton
CASSQGGGRGGSSAQYF	CASSQGGGRGGSSAQYF	singleton
CASSWTAGAGELFF	CASSWTAGAGELFF	singleton
CASSRQLENTIYF	CASSRQLENTIYF	singleton
CASSVQGPDTQYF	CASSVQGPDTQYF	singleton
CASSQEEGGGAGGRTDTQYF	CASSQEEGGGAGGRTDTQYF	singleton
CASSLLTPRETQYF	CASSLLTPRETQYF	singleton
CASRTRWVRQGASEAFF	CASRTRWVRQGASEAFF	singleton
CAIGGQGFEAFF	CAIGGQGFEAFF	singleton
CASSAAETGNTIYF	CASSAAETGNTIYF	singleton
CASSLSLADTIYF	CASSLSLADTIYF	singleton
CSARDFLAGIGRETQYF	CSARDFLAGIGRETQYF	singleton
CASSSGQGFRGTEAFF	CASSSGQGFRGTEAFF	singleton
CASSLGISGRAADTQYF	CASSLGISGRAADTQYF	singleton
CASSPKGDRPLGF	CASSPKGDRPLGF	singleton
CASSRRRDTEAFF	CASSRRRDTEAFF	singleton
CSARLVLTGRGTEAFF	CSARLVLTGRGTEAFF	singleton
CASRIDVTPGSPLHF	CASRIDVTPGSPLHF	singleton
CSVEGIQGGRTEAFF	CSVEGIQGGRTEAFF	singleton
CASSPPDGTGELFF	CASSPPDGTGELFF	singleton
CASRPPGGGGGYTF	CASRPPGGGGGYTF	singleton
CASSFSEGRGPKETQYF	CASSFSEGRGPKETQYF	singleton
CATSDDRAGELFF	CATSDDRAGELFF	singleton
CASSRSQETEAFF	CASSRSQETEAFF	singleton
CATSRGASGQETQYF	CATSRGASGQETQYF	singleton
CASSQDGVSTDTQYF	CASSQDGVSTDTQYF	singleton
CASSYPGLAGKDTQYF	CASSYPGLAGKDTQYF	singleton
CASSLKPLTIAGRQETQYF	CASSLKPLTIAGRQETQYF	singleton
CASSRRQQNTEAFF	CASSRRQQNTEAFF	singleton
CASSIAATGPDGELFF	CASSIAATGPDGELFF	singleton
CASSVTGHSNQPQHF	CASSVTGHSNQPQHF	singleton
CASSRATATDTQYF	CASSRATATDTQYF	singleton
CASSPRGGYEQYF	CASSPRGGYEQYF	singleton
CASSLRTSGYYTGELFF	CASSLRTSGYYTGELFF	singleton
CAWSVRGWDSSYEQYF	CAWSVRGWDSSYEQYF	singleton
CASSRPQGHEQFF	CASSRPQGHEQFF	singleton
CASSQGLRFQLGETQYF	CASSQGLRFQLGETQYF	singleton
CASSLAYAGANYEQYF	CASSLAYAGANYEQYF	singleton
CASSLFGGRTNEKLFF	CASSLFGGRTNEKLFF	singleton
CSARDAGRGGTGELFF	CSARDAGRGGTGELFF	singleton
CASSLGPDDEQFF	CASSLGPDDEQFF	singleton
CASSQRGTEIQYF	CASSQRGTEIQYF	singleton
CASSLGSGLNTEAFF	CASSLGSGLNTEAFF	singleton
CASSVSGGPSTGELFF	CASSVSGGPSTGELFF	singleton
CSIPGLRDTEAFF	CSIPGLRDTEAFF	singleton
CASSLITEAFF	CASSLITEAFF	singleton
CASSLSYLPGPAGYTF	CASSLSYLPGPAGYTF	singleton
CSAIPTGFHTEAFF	CSAIPTGFHTEAFF	singleton
CASSLLTDGVGTGELFF	CASSLLTDGVGTGELFF	singleton
CASSPGVSRVVYEQYF	CASSPGVSRVVYEQYF	singleton
CSARGGQGNNSPLHF	CSARGGQGNNSPLHF	singleton
CASSPRLDRVTEAFF	CASSPRLDRVTEAFF	singleton
CASSQDREPGANVLTF	CASSQDREPGANVLTF	singleton
CASSSIVWTLNRESLYEQYF	CASSSIVWTLNRESLYEQYF	singleton
CASSLLRQGAGEQFF	CASSLLRQGAGEQFF	singleton
CASSPSQRAYNEKLFF	CASSPSQRAYNEKLFF	singleton
CASMNGGYTEAFF	CASMNGGYTEAFF	singleton
CASSYRTVQETQYF	CASSYRTVQETQYF	singleton
CASTLRGGTEAFF	CASTLRGGTEAFF	singleton
CASSSDRDLYNEQFF	CASSSDRDLYNEQFF	singleton
CASSSRQGSYNSPLHF	CASSSRQGSYNSPLHF	singleton
CATSLVELSTDTQYF	CATSLVELSTDTQYF	singleton
CASSFLMNTEAFF	CASSFLMNTEAFF	singleton
CASSQDREGNTIYF	CASSQDREGNTIYF	singleton
CASSPITSGNTIYF	CASSPITSGNTIYF	singleton
CASSTLTAYGYTF	CASSTLTAYGYTF	singleton
CASSQTRGSDTQYF	CASSQTRGSDTQYF	singleton
CASSFRMTSGRETQYF	CASSFRMTSGRETQYF	singleton
CAGLESAGGRETQYF	CAGLESAGGRETQYF	singleton
CASSRSGGANIQYF	CASSRSGGANIQYF	singleton
CASSAPTSGSRYEQFF	CASSAPTSGSRYEQFF	singleton
CSASVAGGLRFF	CSASVAGGLRFF	singleton
CSALGPQSTDTQYF	CSALGPQSTDTQYF	singleton
CASSHTSGGRETQYF	CASSHTSGGRETQYF	singleton
CASSQDRRANTEAFF	CASSQDRRANTEAFF	singleton
CASSLAPRGAGNTIYF	CASSLAPRGAGNTIYF	singleton
CASAPAGRDTQYF	CASAPAGRDTQYF	singleton
CATSPRENNEQFF	CATSPRENNEQFF	singleton
CASSGGPGQRETQYF	CASSGGPGQRETQYF	singleton
CSANSPGQGYGNQPQHF	CSANSPGQGYGNQPQHF	singleton
CACSRALETQYF	CACSRALETQYF	singleton
CASSLTRTGGNTIYF	CASSLTRTGGNTIYF	singleton
CASSSTGGQGAGYTF	CASSSTGGQGAGYTF	singleton
CASSIGGAFTDTQYF	CASSIGGAFTDTQYF	singleton
CSARRGGEQFF	CSARRGGEQFF	singleton
CASSQVAGGTKNIQYF	CASSQVAGGTKNIQYF	singleton
CASSYSITSTGDAYNEQFF	CASSYSITSTGDAYNEQFF	singleton
CAWATSTGELFF	CAWATSTGELFF	singleton
CASSELSGSAGELFF	CASSELSGSAGELFF	singleton
CASSQDLRADEQYF	CASSQDLRADEQYF	singleton
CASSPLGGGKTQYF	CASSPLGGGKTQYF	singleton
CASSFDGFPYTF	CASSFDGFPYTF	singleton
CASSRGTTETQYF	CASSRGTTETQYF	singleton
CASSFLAGTGELFF	CASSFLAGTGELFF	singleton
CASSQGTGWGYTF	CASSQGTGWGYTF	singleton
CASSHDATGGRDTQYF	CASSHDATGGRDTQYF	singleton
CASSLWPTVGPQHF	CASSLWPTVGPQHF	singleton
CASARWGTGELFF	CASARWGTGELFF	singleton
CSARAGVYNEQFF	CSARAGVYNEQFF	singleton
CASSPSAGGPGDTQYF	CASSPSAGGPGDTQYF	singleton
CASSLDGAGQGIQYF	CASSLDGAGQGIQYF	singleton
CASSSGTGAEQYF	CASSSGTGAEQYF	singleton
CASSLALQTYEQYF	CASSLALQTYEQYF	singleton
CASSSPNRQGQYEQYF	CASSSPNRQGQYEQYF	singleton
CASTEPGDQPQHF	CASTEPGDQPQHF	singleton
CASSSWTSGNTGELFF	CASSSWTSGNTGELFF	singleton
CASSPGTSGVGGELFF	CASSPGTSGVGGELFF	singleton
CASSPGDSRSGNTIYF	CASSPGDSRSGNTIYF	singleton
CSASSGSDLGTDTQYF	CSASSGSDLGTDTQYF	singleton
CSASPLVAVRVYNEQFF	CSASPLVAVRVYNEQFF	singleton
CASSLGGAGLELTEAFF	CASSLGGAGLELTEAFF	singleton
CASSGGTGIYGYTF	CASSGGTGIYGYTF	singleton
CASSSNRGGLNTEAFF	CASSSNRGGLNTEAFF	singleton
CASSLEHEQYF	CASSLEHEQYF	singleton
CASSLTGLAIHEQYF	CASSLTGLAIHEQYF	singleton
CASSYPKTGVNEKLFF	CASSYPKTGVNEKLFF	singleton
CASSLAQQPSYNEQFF	CASSLAQQPSYNEQFF	singleton
CASSPQGPHTEAFF	CASSPQGPHTEAFF	singleton
CASSELALAGVFGETQYF	CASSELALAGVFGETQYF	singleton
CASSSRDRGAGYEQYF	CASSSRDRGAGYEQYF	singleton
CASSLERGGIGGTEAFF	CASSLERGGIGGTEAFF	singleton
CASSLGLAPNEQFF	CASSLGLAPNEQFF	singleton
CASLPLRTQRTEAFF	CASLPLRTQRTEAFF	singleton
CASSAPRSGRTYEQYF	CASSAPRSGRTYEQYF	singleton
CASSLSLGTAAYSNYGYTF	CASSLSLGTAAYSNYGYTF	singleton
CASSLYRGDQPQHF	CASSLYRGDQPQHF	singleton
CASSLMGASNTQYF	CASSLMGASNTQYF	singleton
CARRVGSTEAFF	CARRVGSTEAFF	singleton
CASSKGDLTGELFF	CASSKGDLTGELFF	singleton
CASSYEGGRTEAFF	CASSYEGGRTEAFF	singleton
CASTRSEGETQYF	CASTRSEGETQYF	singleton
CASSSGLLHTDTQYF	CASSSGLLHTDTQYF	singleton
CASSLARRTGFGETQYF	CASSLARRTGFGETQYF	singleton
CASSLLGFSGNEQYF	CASSLLGFSGNEQYF	singleton
CASSYTGRLHYEQYF	CASSYTGRLHYEQYF	singleton
CASSSGDASTGELFF	CASSSGDASTGELFF	singleton
CASSLERGYSYEQYF	CASSLERGYSYEQYF	singleton
CASSLSVVETQYF	CASSLSVVETQYF	singleton
CASSLAEGNEQFF	CASSLAEGNEQFF	singleton
CASSLGRDTQYF	CASSLGRDTQYF	singleton
CSAEGTRGSYNEQFF	CSAEGTRGSYNEQFF	singleton
CASRAGTSGSERETQYF	CASRAGTSGSERETQYF	singleton
CASSLASILAGVAYEQYF	CASSLASILAGVAYEQYF	singleton
CASSLDGTGVNTEAFF	CASSLDGTGVNTEAFF	singleton
CASSLTGFHETQYF	CASSLTGFHETQYF	singleton
CATRSAGVNSPLHF	CATRSAGVNSPLHF	singleton
CASSTPGYEQYF	CASSTPGYEQYF	singleton
CASSPGQASSYEQYF	CASSPGQASSYEQYF	singleton
CASSPIGGGYNEQFF	CASSPIGGGYNEQFF	singleton
CASSPSWGGADTQYF	CASSPSWGGADTQYF	singleton
CASSSGVRIRSNQPQHF	CASSSGVRIRSNQPQHF	singleton
CASSSTGTAFF	CASSSTGTAFF	singleton
CSALGGRSVSYNEQFF	CSALGGRSVSYNEQFF	singleton
CAWSVQYAPLHF	CAWSVQYAPLHF	singleton
CSAYRGGFGEQYF	CSAYRGGFGEQYF	singleton
CSARDQGGDEKLFF	CSARDQGGDEKLFF	singleton
CASNIRADTRFYGYTF	CASNIRADTRFYGYTF	singleton
CASSFSSGGDTEAFF	CASSFSSGGDTEAFF	singleton
CASSSAGMRVGEQYF	CASSSAGMRVGEQYF	singleton
CSASSGTGVPGELFF	CSASSGTGVPGELFF	singleton
CASSVPWGGREVDQPQHF	CASSVPWGGREVDQPQHF	singleton
CASSLNREEQYF	CASSLNREEQYF	singleton
CASSYDLAFF	CASSYDLAFF	singleton
CASSFREGGGNIQYF	CASSFREGGGNIQYF	singleton
CSARPWGVGIDTQYF	CSARPWGVGIDTQYF	singleton
CASSRGGANTGELFF	CASSRGGANTGELFF	singleton
CSARTSSYNEQFF	CSARTSSYNEQFF	singleton
CSARYRTGRSEAFF	CSARYRTGRSEAFF	singleton
CASSLSRSGGRELFF	CASSLSRSGGRELFF	singleton
CASSPPLQGRGDTEAFF	CASSPPLQGRGDTEAFF	singleton
CASRPSDSLNTEAFF	CASRPSDSLNTEAFF	singleton
CASIGRPNEKLFF	CASIGRPNEKLFF	singleton
CASSGRGGNEAFF	CASSGRGGNEAFF	singleton
CASSFRLRPITDTQYF	CASSFRLRPITDTQYF	singleton
CASSEAGGPGDEQFF	CASSEAGGPGDEQFF	singleton
CASSLGRGGQPQHF	CASSLGRGGQPQHF	singleton
CASSLPSGRTRYNEQFF	CASSLPSGRTRYNEQFF	singleton
CASSADGTRNPNEQFF	CASSADGTRNPNEQFF	singleton
CATSAVAGGPYNEQFF	CATSAVAGGPYNEQFF	singleton
CASRRIGSNQPQHF	CASRRIGSNQPQHF	singleton
CASSLTETYEQYF	CASSLTETYEQYF	singleton
CSARRQGSTGELFF	CSARRQGSTGELFF	singleton
CASSLWGTYNSPLHF	CASSLWGTYNSPLHF	singleton
CASMTLGQPQHF	CASMTLGQPQHF	singleton
CASSSWGVSSYEQYF	CASSSWGVSSYEQYF	singleton
CASRTGTDNGYTF	CASRTGTDNGYTF	singleton
CATSREAGGGYEQYF	CATSREAGGGYEQYF	singleton
CASSGFGGVKTQYF	CASSGFGGVKTQYF	singleton
CASSLLGTGASEQFF	CASSLLGTGASEQFF	singleton
CAWRAEVGAFF	CAWRAEVGAFF	singleton
CASSFGRDGEKLFF	CASSFGRDGEKLFF	singleton
CASSLSGTGKPQHF	CASSLSGTGKPQHF	singleton
CASSRSSGPSYEQYF	CASSRSSGPSYEQYF	singleton
CASSSDGTYGYTF	CASSSDGTYGYTF	singleton
CASRIDRGLPNTEAFF	CASRIDRGLPNTEAFF	singleton
CASSRQGDTGELFF	CASSRQGDTGELFF	singleton
CASSRGGGGNYEQYF	CASSRGGGGNYEQYF	singleton
CASSLDLASGNTIYF	CASSLDLASGNTIYF	singleton
CASSWVAGGGEQYF	CASSWVAGGGEQYF	singleton
CASSLIKSMAEAFF	CASSLIKSMAEAFF	singleton
CASSHGTGWSYEQYF	CASSHGTGWSYEQYF	singleton
CASSLKGDNSPLHF	CASSLKGDNSPLHF	singleton
CASSSPSTSGTYEQYF	CASSSPSTSGTYEQYF	singleton
CASSLPWVSETQYF	CASSLPWVSETQYF	singleton
CASSTGQGVQPQHF	CASSTGQGVQPQHF	singleton
CASSLGASASTDTQYF	CASSLGASASTDTQYF	singleton
CASRDPGLGRQFF	CASRDPGLGRQFF	singleton
CASSSYLVSGANVLTF	CASSSYLVSGANVLTF	singleton
CASSQDLGLATNEQFF	CASSQDLGLATNEQFF	singleton
CSARGEGVGSRYGYTF	CSARGEGVGSRYGYTF	singleton
CASSYRQGYQDEQFF	CASSYRQGYQDEQFF	singleton
CASSTQGWGADIQYF	CASSTQGWGADIQYF	singleton
CASSTTSRWTGRYSGYTF	CASSTTSRWTGRYSGYTF	singleton
CASSQWTSNTGELFF	CASSQWTSNTGELFF	singleton
CASSLGTGEGYTF	CASSLGTGEGYTF	singleton
CSAFAGLKNIQYF	CSAFAGLKNIQYF	singleton
CASSYLYTGVEAFF	CASSYLYTGVEAFF	singleton
CASSVAGRTGELFF	CASSVAGRTGELFF	singleton
CASSIGTGWNTEAFF	CASSIGTGWNTEAFF	singleton
CAWSTQGSDGELFF	CAWSTQGSDGELFF	singleton
CASSSIVQGLEPQHF	CASSSIVQGLEPQHF	singleton
CASSLNRGVDEQFF	CASSLNRGVDEQFF	singleton
CSASEGAGGASEQYF	CSASEGAGGASEQYF	singleton
CASSLGRGGLSTDTQYF	CASSLGRGGLSTDTQYF	singleton
CASSQYGLAGVDTQYF	CASSQYGLAGVDTQYF	singleton
CASRQDAGGSEKLFF	CASRQDAGGSEKLFF	singleton
CSARRQGERTEAFF	CSARRQGERTEAFF	singleton
CASSEGQYNSPLHF	CASSEGQYNSPLHF	singleton
CASSLRTGGKDTQYF	CASSLRTGGKDTQYF	singleton
CASSQDPTSGNTIYF	CASSQDPTSGNTIYF	singleton
CASRSVQGSGNEKLFF	CASRSVQGSGNEKLFF	singleton
CATSDLHLGTDTQYF	CATSDLHLGTDTQYF	singleton
CASSRTGTGTYEQYF	CASSRTGTGTYEQYF	singleton
CASRTSGNVETQYF	CASRTSGNVETQYF	singleton
CASSYSPQGLTQYF	CASSYSPQGLTQYF	singleton
CASSQTQGTGELFF	CASSQTQGTGELFF	singleton
CASSSGQPYEQYF	CASSSGQPYEQYF	singleton
CASIIRTGLGRTEAFF	CASIIRTGLGRTEAFF	singleton
CASSDPGTGTPYSYNEQFF	CASSDPGTGTPYSYNEQFF	singleton
CAAGWAPETQYF	CAAGWAPETQYF	singleton
CASSPERGGRGIQYF	CASSPERGGRGIQYF	singleton
CASRLSGAGVGTQYF	CASRLSGAGVGTQYF	singleton
CASSYDDRVGHGYTF	CASSYDDRVGHGYTF	singleton
CSAKAATEAFF	CSAKAATEAFF	singleton
CASSQVRQGSGYTF	CASSQVRQGSGYTF	singleton
CASSQEIAGGYEQYF	CASSQEIAGGYEQYF	singleton
CASSSGQGAMPQHF	CASSSGQGAMPQHF	singleton
CASGPGTVYEQYF	CASGPGTVYEQYF	singleton
CASSYAGTQGYTF	CASSYAGTQGYTF	singleton
CASSPGTVPSGNTIYF	CASSPGTVPSGNTIYF	singleton
CSAREWTVADEQYF	CSAREWTVADEQYF	singleton
CASSVSASEQETQYF	CASSVSASEQETQYF	singleton
CSAPSALAGGYEQYF	CSAPSALAGGYEQYF	singleton
CAWNVMAGGPREQFF	CAWNVMAGGPREQFF	singleton
CASSGLAGVPSYEQYF	CASSGLAGVPSYEQYF	singleton
CASSYGQAADTQYF	CASSYGQAADTQYF	singleton
CSARTSGSWEFF	CSARTSGSWEFF	singleton
CASSVEVRTEAFF	CASSVEVRTEAFF	singleton
CASSALNRGTEAFF	CASSALNRGTEAFF	singleton
CSASSGMIKNEQFF	CSASSGMIKNEQFF	singleton
CASSLVPPIETQYF	CASSLVPPIETQYF	singleton
CASSEYPDLDEQYF	CASSEYPDLDEQYF	singleton
CSVEGRPMDYGYTF	CSVEGRPMDYGYTF	singleton
CSARDAGGGEKLFF	CSARDAGGGEKLFF	singleton
CASSYSGLNEKLFF	CASSYSGLNEKLFF	singleton
CASSVAGRQTQYF	CASSVAGRQTQYF	singleton
CATSREPWSGGWDTEAFF	CATSREPWSGGWDTEAFF	singleton
CSALGLAGGREQFF	CSALGLAGGREQFF	singleton
CASSSPGLMNTEAFF	CASSSPGLMNTEAFF	singleton
CASSLGGQGNLYGYTF	CASSLGGQGNLYGYTF	singleton
CASSQDRAAGSKPQHF	CASSQDRAAGSKPQHF	singleton
CASSQDSRANEQFF	CASSQDSRANEQFF	singleton
CSVDSRGFDTEAFF	CSVDSRGFDTEAFF	singleton
CASALSTGGSNEQFF	CASALSTGGSNEQFF	singleton
CASSDITSGGNSYEQYF	CASSDITSGGNSYEQYF	singleton
CASSEGQGSYEQYF	CASSEGQGSYEQYF	singleton
CASSALPGEQYF	CASSALPGEQYF	singleton
CASSPRSWYASYNEQFF	CASSPRSWYASYNEQFF	singleton
CASRGRGQPQHF	CASRGRGQPQHF	singleton
CASSQRKQGRAEKLFF	CASSQRKQGRAEKLFF	singleton
CASSSRSGTSEGDEQFF	CASSSRSGTSEGDEQFF	singleton
CASTLAGGLGTQYF	CASTLAGGLGTQYF	singleton
CASSPRDRGKVQYF	CASSPRDRGKVQYF	singleton
CASSERLAGRDTQYF	CASSERLAGRDTQYF	singleton
CASSPQGAVTEAFF	CASSPQGAVTEAFF	singleton
CASSSPPTGRGSPLHF	CASSSPPTGRGSPLHF	singleton
CASSQSPRTEAFF	CASSQSPRTEAFF	singleton
CASSSLGRLTGELFF	CASSSLGRLTGELFF	singleton
CAISESPLAAYTQYF	CAISESPLAAYTQYF	singleton
CASAFSVAEKLFF	CASAFSVAEKLFF	singleton
CASSTGLVAGIHEQYF	CASSTGLVAGIHEQYF	singleton
CASSQEGPRTSGGYTQYF	CASSQEGPRTSGGYTQYF	singleton
CASSLVGQESETQETQYF	CASSLVGQESETQETQYF	singleton
CSASASGAGELFF	CSASASGAGELFF	singleton
CASSSITDTQYF	CASSSITDTQYF	singleton
CASSPTSFPQYF	CASSPTSFPQYF	singleton
CASSIAGGPQHF	CASSIAGGPQHF	singleton
CATSRDSLARGDEQYF	CATSRDSLARGDEQYF	singleton
CAISGVGGANNEQFF	CAISGVGGANNEQFF	singleton
CARLSQGDTEAFF	CARLSQGDTEAFF	singleton
CASSLGGGSYEQYF	CASSLGGGSYEQYF	singleton
CASKFVHNSPLHF	CASKFVHNSPLHF	singleton
CASSQDLPGGTNLGELFF	CASSQDLPGGTNLGELFF	singleton
CASSPDRNSYNEQFF	CASSPDRNSYNEQFF	singleton
CASTSGQGTDTQYF	CASTSGQGTDTQYF	singleton
CASSLAGEKNIQYF	CASSLAGEKNIQYF	singleton
CASVRPDATGNYGYTF	CASVRPDATGNYGYTF	singleton
CASTGRPYEQYF	CASTGRPYEQYF	singleton
CASSPVRDGQPQHF	CASSPVRDGQPQHF	singleton
CSARDPQGAAYEQYF	CSARDPQGAAYEQYF	singleton
CASSSAGLDTEAFF	CASSSAGLDTEAFF	singleton
CASNGGPNTGELFF	CASNGGPNTGELFF	singleton
CASSDDGGKADTQYF	CASSDDGGKADTQYF	singleton
CSVEMGPFGEQFF	CSVEMGPFGEQFF	singleton
CACAALEGVNEKLFF	CACAALEGVNEKLFF	singleton
CATSSDHPYEQYF	CATSSDHPYEQYF	singleton
CAWSVRVSLAKNIQYF	CAWSVRVSLAKNIQYF	singleton
CASSQPGPPLVGEKLFF	CASSQPGPPLVGEKLFF	singleton
CASSLGLAEGEQFF	CASSLGLAEGEQFF	singleton
CASGRGGSGANVLTF	CASGRGGSGANVLTF	singleton
CASRLAETNTGELFF	CASRLAETNTGELFF	singleton
CASRQNDRGTNYGYTF	CASRQNDRGTNYGYTF	singleton
CASSYRGTGPFGYTF	CASSYRGTGPFGYTF	singleton
CASSLRVDSSNQPQHF	CASSLRVDSSNQPQHF	singleton
CASSVVGGRELTEAFF	CASSVVGGRELTEAFF	singleton
CASSLVSTAYNEQFF	CASSLVSTAYNEQFF	singleton
CASSLGLAGIGELFF	CASSLGLAGIGELFF	singleton
CASSSSSHVTGELFF	CASSSSSHVTGELFF	singleton
CASQTANQPQHF	CASQTANQPQHF	singleton
CATSDLTGQGDADTQYF	CATSDLTGQGDADTQYF	singleton
CASSHRTGSYPDTQYF	CASSHRTGSYPDTQYF	singleton
CASRLDRLNTEAFF	CASRLDRLNTEAFF	singleton
CSARGTASYNSPLHF	CSARGTASYNSPLHF	singleton
CASSRRTSSSGANVLTF	CASSRRTSSSGANVLTF	singleton
CSVEEDRGYEQYF	CSVEEDRGYEQYF	singleton
CSATLEGAIGYTF	CSATLEGAIGYTF	singleton
CASSPIAGDSPLHF	CASSPIAGDSPLHF	singleton
CASSPYGQGRTEAFF	CASSPYGQGRTEAFF	singleton
CASSLEGANTF	CASSLEGANTF	singleton
CASTGGTRAGREQFF	CASTGGTRAGREQFF	singleton
CASSVASQPYEQYF	CASSVASQPYEQYF	singleton
CASSLEGTSGNEQFF	CASSLEGTSGNEQFF	singleton
CASSFRGQGNYGYTF	CASSFRGQGNYGYTF	singleton
CASSYSAGGGYTF	CASSYSAGGGYTF	singleton
CAIGGRQSSSYNEQFF	CAIGGRQSSSYNEQFF	singleton
CASGSKHTGELFF	CASGSKHTGELFF	singleton
CSVLESPLHF	CSVLESPLHF	singleton
CASSERGYGYTF	CASSERGYGYTF	singleton
CASSYAGVPYEQYF	CASSYAGVPYEQYF	singleton
CSATQAVAKNIQYF	CSATQAVAKNIQYF	singleton
CSVEFLAEAGELFF	CSVEFLAEAGELFF	singleton
CASSAQISTNEQFF	CASSAQISTNEQFF	singleton
CASSLGADF	CASSLGADF	singleton
CASSQETGANVLTF	CASSQETGANVLTF	singleton
CASSSASPGNTIYF	CASSSASPGNTIYF	singleton
CASSPQRNEQFF	CASSPQRNEQFF	singleton
CATRKGTGANVLTF	CATRKGTGANVLTF	singleton
CASTPLGGDLYGYTF	CASTPLGGDLYGYTF	singleton
CASSENRDQAFF	CASSENRDQAFF	singleton
CASSYSRGGYEQYF	CASSYSRGGYEQYF	singleton
CSAREDIRGYYGYTF	CSAREDIRGYYGYTF	singleton
CASSLEFSRAAATEAFF	CASSLEFSRAAATEAFF	singleton
CASTLKGPRDGYTF	CASTLKGPRDGYTF	singleton
CATKGTSTDTQYF	CATKGTSTDTQYF	singleton
CASSANRGLYNEQFF	CASSANRGLYNEQFF	singleton
CASSLNFGANVLTF	CASSLNFGANVLTF	singleton
CATRRQGNTYEQYF	CATRRQGNTYEQYF	singleton
CASSSGTPTYEQYF	CASSSGTPTYEQYF	singleton
CASSSGTSGYNEQFF	CASSSGTSGYNEQFF	singleton
CASRYGTGDYNEQFF	CASRYGTGDYNEQFF	singleton
CASSFSGRKTGELFF	CASSFSGRKTGELFF	singleton
CAWSHSGGGYEQYF	CAWSHSGGGYEQYF	singleton
CASSGGGQGKDTQYF	CASSGGGQGKDTQYF	singleton
CASSYRGGPYEQYF	CASSYRGGPYEQYF	singleton
CASSRLGQGAYEQYF	CASSRLGQGAYEQYF	singleton
CASSSSGTSNYEQFF	CASSSSGTSNYEQFF	singleton
CASSLAGTNEQFF	CASSLAGTNEQFF	singleton
CSAQIYNSPLHF	CSAQIYNSPLHF	singleton
CASSDWGRGRGETQYF	CASSDWGRGRGETQYF	singleton
CASTLGAAYQETQYF	CASTLGAAYQETQYF	singleton
CATKDRTGELFF	CATKDRTGELFF	singleton
CASSTAERTDTQYF	CASSTAERTDTQYF	singleton
CASSQEGLATTDTQYF	CASSQEGLATTDTQYF	singleton
CARKTGGGGPQETQYF	CARKTGGGGPQETQYF	singleton
CAWSTTSGRFINEQFF	CAWSTTSGRFINEQFF	singleton
CASTALDSTDTQYF	CASTALDSTDTQYF	singleton
CASSEPGGGTDTQYF	CASSEPGGGTDTQYF	singleton
CASSPDRSGPQHF	CASSPDRSGPQHF	singleton
CSAREGGAYSGNTIYF	CSAREGGAYSGNTIYF	singleton
CASSTSSGGTYEQYF	CASSTSSGGTYEQYF	singleton
CSVELKKGGDTEAFF	CSVELKKGGDTEAFF	singleton
CASSRQGRVSYEQYF	CASSRQGRVSYEQYF	singleton
CASWLAGVRETQYF	CASWLAGVRETQYF	singleton
CASSYLPRGSGNTIYF	CASSYLPRGSGNTIYF	singleton
CASMTTGGISGANVLTF	CASMTTGGISGANVLTF	singleton
CATRPQGGAGNTIYF	CATRPQGGAGNTIYF	singleton
CASSRLLAFTDTQYF	CASSRLLAFTDTQYF	singleton
CASSESTLADTQYF	CASSESTLADTQYF	singleton
CASSQHLAGTTETQYF	CASSQHLAGTTETQYF	singleton
CASSLDRSGGYTF	CASSLDRSGGYTF	singleton
CASSARLAPKAGELFF	CASSARLAPKAGELFF	singleton
CASSLNLRVGTGNTGELFF	CASSLNLRVGTGNTGELFF	singleton
CASSQGLAGLYEQYF	CASSQGLAGLYEQYF	singleton
CASRPTRILSVGELFF	CASRPTRILSVGELFF	singleton
CASSREGRLAGLKTQYF	CASSREGRLAGLKTQYF	singleton
CAIRDRENTEAFF	CAIRDRENTEAFF	singleton
CASSLGVPRGRLLLRQFF	CASSLGVPRGRLLLRQFF	singleton
CASSWGTGLGYF	CASSWGTGLGYF	singleton
CASSRDYSPLHF	CASSRDYSPLHF	singleton
CASRPRGGLSGYTF	CASRPRGGLSGYTF	singleton
CASSPTGRTAYEQYF	CASSPTGRTAYEQYF	singleton
CASSLMFGDTQYF	CASSLMFGDTQYF	singleton
CASSYDRVSYEQYF	CASSYDRVSYEQYF	singleton
CASSLAYSSNYGYTF	CASSLAYSSNYGYTF	singleton
CASSVAAHNYGYTF	CASSVAAHNYGYTF	singleton
CSASGSPDTQYF	CSASGSPDTQYF	singleton
CASSQSRGAYNEQFF	CASSQSRGAYNEQFF	singleton
CSAPPVLAGSYEQYF	CSAPPVLAGSYEQYF	singleton
CASSPPGGNTIYF	CASSPPGGNTIYF	singleton
CSASWGGGEQYF	CSASWGGGEQYF	singleton
CASSLFTGTFNDYTF	CASSLFTGTFNDYTF	singleton
CASSLTLLAGGRGSYNEQFF	CASSLTLLAGGRGSYNEQFF	singleton
CASSVSSAGGTEAFF	CASSVSSAGGTEAFF	singleton
CSARDGRADTQYF	CSARDGRADTQYF	singleton
CASSRTGEGQPQHF	CASSRTGEGQPQHF	singleton
CASSLPGGANEQFF	CASSLPGGANEQFF	singleton
CAISTGHSVGNEQFF	CAISTGHSVGNEQFF	singleton
CASTKDRDPLVGLFF	CASTKDRDPLVGLFF	singleton
CASSVVAGAQETQYF	CASSVVAGAQETQYF	singleton
CASTSERGGEQFF	CASTSERGGEQFF	singleton
CASSLRTLGYEQYF	CASSLRTLGYEQYF	singleton
CASSIRGLAKNIQYF	CASSIRGLAKNIQYF	singleton
CASSLGQNTGELFF	CASSLGQNTGELFF	singleton
CSVRLTGEKLFF	CSVRLTGEKLFF	singleton
CASSSGLAGGKTGELFF	CASSSGLAGGKTGELFF	singleton
CASRARGYNEQFF	CASRARGYNEQFF	singleton
CASSPTTGVQFF	CASSPTTGVQFF	singleton
CASSPDSNSLNEQFF	CASSPDSNSLNEQFF	singleton
CASRRDGSYEQYF	CASRRDGSYEQYF	singleton
CAIRTGDLQDSPLHF	CAIRTGDLQDSPLHF	singleton
CASSLSPDRVWGYTF	CASSLSPDRVWGYTF	singleton
CASSHLSTYNEQFF	CASSHLSTYNEQFF	singleton
CASSAAGSTDTQYF	CASSAAGSTDTQYF	singleton
CASRGGRDTEAFF	CASRGGRDTEAFF	singleton
CASSFNDGYTF	CASSFNDGYTF	singleton
CAWSRSRGGETQYF	CAWSRSRGGETQYF	singleton
CASNTGREPYGYTF	CASNTGREPYGYTF	singleton
CASSPQAVTYGYTF	CASSPQAVTYGYTF	singleton
CASSSRTGHLFYEQYF	CASSSRTGHLFYEQYF	singleton
CASSLRVASGVHNEQFF	CASSLRVASGVHNEQFF	singleton
CASSSLAGGLLDTQYF	CASSSLAGGLLDTQYF	singleton
CASSLGPQGPYNEQFF	CASSLGPQGPYNEQFF	singleton
CSARGPGVPYNEQFF	CSARGPGVPYNEQFF	singleton
CAGAADNEKLFF	CAGAADNEKLFF	singleton
CASSLVGVGVQPQHF	CASSLVGVGVQPQHF	singleton
CASSLDGFSYNEQFF	CASSLDGFSYNEQFF	singleton
CASSSRQTNEKLFF	CASSSRQTNEKLFF	singleton
CASSPGIAADTQYF	CASSPGIAADTQYF	singleton
CSALNRGKVGEQYF	CSALNRGKVGEQYF	singleton
CASSSGGGDYEQYF	CASSSGGGDYEQYF	singleton
CASRVGGGSEKLFF	CASRVGGGSEKLFF	singleton
CASSLDGTGTTGELFF	CASSLDGTGTTGELFF	singleton
CASRDPGGNQPQHF	CASRDPGGNQPQHF	singleton
CATKRATYEQYF	CATKRATYEQYF	singleton
CASSLDFYEQYF	CASSLDFYEQYF	singleton
CASSPRSGGRFNEQFF	CASSPRSGGRFNEQFF	singleton
CASSLASRGGEQYF	CASSLASRGGEQYF	singleton
CASTSGQRNSPLHF	CASTSGQRNSPLHF	singleton
CASTATTVGEQFF	CASTATTVGEQFF	singleton
CASSSSTPTSTDTQYF	CASSSSTPTSTDTQYF	singleton
CASSQGSQGNSPLHF	CASSQGSQGNSPLHF	singleton
CASSPVNRGDTEAFF	CASSPVNRGDTEAFF	singleton
CASSQERSGAGSYGYTF	CASSQERSGAGSYGYTF	singleton
CGTWTPNEKLFF	CGTWTPNEKLFF	singleton
CASSSISGRAADTQYF	CASSSISGRAADTQYF	singleton
CASSQEWLGTEAFF	CASSQEWLGTEAFF	singleton
CASSPGLADTDTQYF	CASSPGLADTDTQYF	singleton
CASSQTWTSGVFGDTQYF	CASSQTWTSGVFGDTQYF	singleton
CASTPDRGTNNEQFF	CASTPDRGTNNEQFF	singleton
CASSPQNRAEQYF	CASSPQNRAEQYF	singleton
CASSLSSGLGKQFF	CASSLSSGLGKQFF	singleton
CSAGGQAPLVEQYF	CSAGGQAPLVEQYF	singleton
CASSIISGGETQYF	CASSIISGGETQYF	singleton
CASVRQGAPTEAFF	CASVRQGAPTEAFF	singleton
CASSLGRKITVNTEAFF	CASSLGRKITVNTEAFF	singleton
CASGSRPGSGSYNEQFF	CASGSRPGSGSYNEQFF	singleton
CASSLLNQGLETQYF	CASSLLNQGLETQYF	singleton
CASSLQGIETQYF	CASSLQGIETQYF	singleton
CASRPRVRNTEAFF	CASRPRVRNTEAFF	singleton
CASSPPGRPYGFYGYTF	CASSPPGRPYGFYGYTF	singleton
CASSLDGGQGQETQYF	CASSLDGGQGQETQYF	singleton
CASTGGGEETQYF	CASTGGGEETQYF	singleton
CASSSGGPNAEAFF	CASSSGGPNAEAFF	singleton
CASSFGELFF	CASSFGELFF	singleton
CASSRHEVYEQYF	CASSRHEVYEQYF	singleton
CASSQVRGASDTQYF	CASSQVRGASDTQYF	singleton
CSPFLEREAFF	CSPFLEREAFF	singleton
CASRTAGNEQFF	CASRTAGNEQFF	singleton
CASSQGTLNTGELFF	CASSQGTLNTGELFF	singleton
CASSRGINEKLFF	CASSRGINEKLFF	singleton
CSVENQAFF	CSVENQAFF	singleton
CASSSQTGQPQHF	CASSSQTGQPQHF	singleton
CASSPVGGTANTEAFF	CASSPVGGTANTEAFF	singleton
CASSFTARGGAGELFF	CASSFTARGGAGELFF	singleton
CASSSQGTNTGELFF	CASSSQGTNTGELFF	singleton
CASSPGTANNSPLHF	CASSPGTANNSPLHF	singleton
CASSFNGDGQRGNTQYF	CASSFNGDGQRGNTQYF	singleton
CASSVDRANYGYTF	CASSVDRANYGYTF	singleton
CASSLDGQGAYEQYF	CASSLDGQGAYEQYF	singleton
CASSSGGERGHTDTQYF	CASSSGGERGHTDTQYF	singleton
CATSDPTRQLYNEQFF	CATSDPTRQLYNEQFF	singleton
CASSITGVSTDTQYF	CASSITGVSTDTQYF	singleton
CASSEGRLAEDTQYF	CASSEGRLAEDTQYF	singleton
CASSYLQRGGQYNEQFF	CASSYLQRGGQYNEQFF	singleton
CASSLAARGANVLTF	CASSLAARGANVLTF	singleton
CASSLRTSGPYNEQFF	CASSLRTSGPYNEQFF	singleton
CASIRTGENYGYTF	CASIRTGENYGYTF	singleton
CASDPGQGGSYNEQFF	CASDPGQGGSYNEQFF	singleton
CASGDPLVLRNEQFF	CASGDPLVLRNEQFF	singleton
CASKPIPSGSYNEQFF	CASKPIPSGSYNEQFF	singleton
CASNLQGASEQYF	CASNLQGASEQYF	singleton
CASSLDTGRAEAFF	CASSLDTGRAEAFF	singleton
CASRRWTSGGQETQYF	CASRRWTSGGQETQYF	singleton
CASSPGQNSHEQYF	CASSPGQNSHEQYF	singleton
CASSLPSGSGNYEQYF	CASSLPSGSGNYEQYF	singleton
CSARVPWSGSSTDTQYF	CSARVPWSGSSTDTQYF	singleton
CATSDLPQEAFF	CATSDLPQEAFF	singleton
CAWSAPDSYEQYF	CAWSAPDSYEQYF	singleton
CAWSVYTAGELFF	CAWSVYTAGELFF	singleton
CASSRTPRTEAFF	CASSRTPRTEAFF	singleton
CASSDWGADTQYF	CASSDWGADTQYF	singleton
CASSQDRSGGRNEQFF	CASSQDRSGGRNEQFF	singleton
CASSRTPNNEQFF	CASSRTPNNEQFF	singleton
CASSQGLGSYNEQFF	CASSQGLGSYNEQFF	singleton
CASKVGGRGSSYEQYF	CASKVGGRGSSYEQYF	singleton
CASSLAPDEQFF	CASSLAPDEQFF	singleton
CAISEVAGAQYF	CAISEVAGAQYF	singleton
CASSQELRQGTDTQYF	CASSQELRQGTDTQYF	singleton
CASSFASAAPNEQFF	CASSFASAAPNEQFF	singleton
CASSKATDTTNYGYTF	CASSKATDTTNYGYTF	singleton
CASSPLMTGELFF	CASSPLMTGELFF	singleton
CASSYRAKDTGELFF	CASSYRAKDTGELFF	singleton
CASSKTAGGDSYEQYF	CASSKTAGGDSYEQYF	singleton
CATSSGSLTYEQYF	CATSSGSLTYEQYF	singleton
CASSYRPSAYNEQFF	CASSYRPSAYNEQFF	singleton
CASSDRVGDNEQFF	CASSDRVGDNEQFF	singleton
CSADLAGGGETQYF	CSADLAGGGETQYF	singleton
CASRIDTNEQYF	CASRIDTNEQYF	singleton
CASSLGVGRRGTEAFF	CASSLGVGRRGTEAFF	singleton
CSAKQGGGNTIYF	CSAKQGGGNTIYF	singleton
CASSLGAVTGELFF	CASSLGAVTGELFF	singleton
CSARDPTGWGETQYF	CSARDPTGWGETQYF	singleton
CASSPEGGGVVQYF	CASSPEGGGVVQYF	singleton
CSARAEGLAGVYEQYF	CSARAEGLAGVYEQYF	singleton
CASSSGYRGINYGYTF	CASSSGYRGINYGYTF	singleton
CASSEEGEWVYNEQFF	CASSEEGEWVYNEQFF	singleton
CASSPNDRVLYGYTF	CASSPNDRVLYGYTF	singleton
CASKRSKTNEKLFF	CASKRSKTNEKLFF	singleton
CASSVGFEGGAGVGEQYF	CASSVGFEGGAGVGEQYF	singleton
CAWDRTGHGYTF	CAWDRTGHGYTF	singleton
CASSPGTGLKLFF	CASSPGTGLKLFF	singleton
CASSSGGRGGETQYF	CASSSGGRGGETQYF	singleton
CASSVSGGWGTGELFF	CASSVSGGWGTGELFF	singleton
CATSDSDRVETQYF	CATSDSDRVETQYF	singleton
CATSSRNRAGANVLTF	CATSSRNRAGANVLTF	singleton
CASTPSSYNEQFF	CASTPSSYNEQFF	singleton
CSVETGRQSDTEAFF	CSVETGRQSDTEAFF	singleton
CASSYTASYEQYF	CASSYTASYEQYF	singleton
CASSLAPTDTQYF	CASSLAPTDTQYF	singleton
CASTEDSKNIQYF	CASTEDSKNIQYF	singleton
CASSYGRASGGSEAFF	CASSYGRASGGSEAFF	singleton
CASVKGKSSYNEQFF	CASVKGKSSYNEQFF	singleton
CSATLPRGETQYF	CSATLPRGETQYF	singleton
CASSEGSSVEGEQYF	CASSEGSSVEGEQYF	singleton
CASSLLGSSGNTIYF	CASSLLGSSGNTIYF	singleton
CASRNGGAGSTDTQYF	CASRNGGAGSTDTQYF	singleton
CASSVQTSGRATQYF	CASSVQTSGRATQYF	singleton
CATSTNWGGSETQYF	CATSTNWGGSETQYF	singleton
CASSPLLAGAQEQFF	CASSPLLAGAQEQFF	singleton
CAWSGVDRGRTGELFF	CAWSGVDRGRTGELFF	singleton
CASSPRTGNNSPLHF	CASSPRTGNNSPLHF	singleton
CASSILYGGRSSYNEQFF	CASSILYGGRSSYNEQFF	singleton
CASSQDLLGIYGYTF	CASSQDLLGIYGYTF	singleton
CASRPQTNTEAFF	CASRPQTNTEAFF	singleton
CSVVRDRVQETQYF	CSVVRDRVQETQYF	singleton
CASSADPGLAGARYNEQFF	CASSADPGLAGARYNEQFF	singleton
CSARVGTYGYTF	CSARVGTYGYTF	singleton
CASSSTPMNTEAFF	CASSSTPMNTEAFF	singleton
CASSVGPGIAYEQYF	CASSVGPGIAYEQYF	singleton
CASSSTRQTNTEAFF	CASSSTRQTNTEAFF	singleton
CSARAASGSADTQYF	CSARAASGSADTQYF	singleton
CASSYVALAGGRNEQFF	CASSYVALAGGRNEQFF	singleton
CAISESAGVVTEAFF	CAISESAGVVTEAFF	singleton
CASSARQGVYTEAFF	CASSARQGVYTEAFF	singleton
CSVAHGRAPDTQYF	CSVAHGRAPDTQYF	singleton
CAWSVQGPGEQYF	CAWSVQGPGEQYF	singleton
CASSPLGWGYGTRGSEQFF	CASSPLGWGYGTRGSEQFF	singleton
CASSLAQTYNEQFF	CASSLAQTYNEQFF	singleton
CASAPRGGVEQFF	CASAPRGGVEQFF	singleton
CASADRAGANVLTF	CASADRAGANVLTF	singleton
CATGSGSPYEQYF	CATGSGSPYEQYF	singleton
CSARNSLLYPGANVLTF	CSARNSLLYPGANVLTF	singleton
CASSPWPQRANEQFF	CASSPWPQRANEQFF	singleton
CSAQRDRDEKLFF	CSAQRDRDEKLFF	singleton
CASSSSFGLAGDPRELFF	CASSSSFGLAGDPRELFF	singleton
CASSQTPTEAFF	CASSQTPTEAFF	singleton
CASSLDRVLSPLHF	CASSLDRVLSPLHF	singleton
CASSIDYRRGGWDTQYF	CASSIDYRRGGWDTQYF	singleton
CASSIQGTPQETQYF	CASSIQGTPQETQYF	singleton
CSAREGAEKLFF	CSAREGAEKLFF	singleton
CSARGRQETQYF	CSARGRQETQYF	singleton
CASSLGRATLSNEQFF	CASSLGRATLSNEQFF	singleton
CASSFAGNERNTIYF	CASSFAGNERNTIYF	singleton
CASSRTGGGPNEQYF	CASSRTGGGPNEQYF	singleton
CASSFSRRLLAGDGDTQYF	CASSFSRRLLAGDGDTQYF	singleton
CAWSITGREKLFF	CAWSITGREKLFF	singleton
CASSLTARGPGANVLTF	CASSLTARGPGANVLTF	singleton
CASGAVGSKPQHF	CASGAVGSKPQHF	singleton
CSARRQTMNTEAFF	CSARRQTMNTEAFF	singleton
CASSFSGPLNSPLHF	CASSFSGPLNSPLHF	singleton
CASSLAAGYEETQYF	CASSLAAGYEETQYF	singleton
CASSSRTGGSYTF	CASSSRTGGSYTF	singleton
CATSRRQEQFF	CATSRRQEQFF	singleton
CASSSGSEKLFF	CASSSGSEKLFF	singleton
CASSSRASRIHEQYF	CASSSRASRIHEQYF	singleton
CASSNPQAGGTDTQYF	CASSNPQAGGTDTQYF	singleton
CASSQAPGTGINEQFF	CASSQAPGTGINEQFF	singleton
CASSVDLILSGNTIYF	CASSVDLILSGNTIYF	singleton
CASSQGGEGFTEAFF	CASSQGGEGFTEAFF	singleton
CASSRRNTGGRNTGELFF	CASSRRNTGGRNTGELFF	singleton
CASSYSDRNTEAFF	CASSYSDRNTEAFF	singleton
CASSTRPAGQGYEQYF	CASSTRPAGQGYEQYF	singleton
CASSQQGAWTEAFF	CASSQQGAWTEAFF	singleton
CSARIRRAGEYQETQYF	CSARIRRAGEYQETQYF	singleton
CATGDSTYEQYF	CATGDSTYEQYF	singleton
CATSRDGSGGALNTDTQYF	CATSRDGSGGALNTDTQYF	singleton
CASSDEDLYSNQPQHF	CASSDEDLYSNQPQHF	singleton
CASSDPLGTYYEKLFF	CASSDPLGTYYEKLFF	singleton
CASILTGTGRGTEAFF	CASILTGTGRGTEAFF	singleton
CASSSGAGANVLTF	CASSSGAGANVLTF	singleton
CASSLDASGNTIYF	CASSLDASGNTIYF	singleton
CASSFGVNTEAFF	CASSFGVNTEAFF	singleton
CASRLAGVNTGELFF	CASRLAGVNTGELFF	singleton
CATSDGTSEYNEQFF	CATSDGTSEYNEQFF	singleton
CASSSQAGGTDTQYF	CASSSQAGGTDTQYF	singleton
CASSLGTSGLRTHNEQFF	CASSLGTSGLRTHNEQFF	singleton
CASSGREEHEQFF	CASSGREEHEQFF	singleton
CSAMDTQSYNEQFF	CSAMDTQSYNEQFF	singleton
CASSHLQEDTGELFF	CASSHLQEDTGELFF	singleton
CASSIFFGTNQPQHF	CASSIFFGTNQPQHF	singleton
CSAGRRNYGYTF	CSAGRRNYGYTF	singleton
CASSSPGQGDYGYTF	CASSSPGQGDYGYTF	singleton
CASSQSAMINEQFF	CASSQSAMINEQFF	singleton
CASSFSAGSINTQYF	CASSFSAGSINTQYF	singleton
CAIRGDSSSYEQYF	CAIRGDSSSYEQYF	singleton
CATGQGEGTQYF	CATGQGEGTQYF	singleton
CASTQGLSVYNEQFF	CASTQGLSVYNEQFF	singleton
CASSFRANYGYTF	CASSFRANYGYTF	singleton
CASSTPGGSNQPQHF	CASSTPGGSNQPQHF	singleton
CAWSNYNEGNEQYF	CAWSNYNEGNEQYF	singleton
CASSSTSGVAKNIQYF	CASSSTSGVAKNIQYF	singleton
CASSTRTSGEAGTDTQYF	CASSTRTSGEAGTDTQYF	singleton
CASSPARRANSPLHF	CASSPARRANSPLHF	singleton
CASRRLAGPETDTQYF	CASRRLAGPETDTQYF	singleton
CASSYSMSGGPRDTQYF	CASSYSMSGGPRDTQYF	singleton
CASTPLAVGTDTQYF	CASTPLAVGTDTQYF	singleton
CASSYQRGGYNEQFF	CASSYQRGGYNEQFF	singleton
CASSVGPAPGTSGSSYNEQFF	CASSVGPAPGTSGSSYNEQFF	singleton
CSVLLQGGGYTF	CSVLLQGGGYTF	singleton
CAIRDQGNEQFF	CAIRDQGNEQFF	singleton
CSAGDRVNHPDNSPLHF	CSAGDRVNHPDNSPLHF	singleton
CATSRGGGAGGYTF	CATSRGGGAGGYTF	singleton
CATSHEQGHDHF	CATSHEQGHDHF	singleton
CASTIEGRTQYF	CASTIEGRTQYF	singleton
CASSLVRTGTDTQYF	CASSLVRTGTDTQYF	singleton
CASSLGQLLEKLFF	CASSLGQLLEKLFF	singleton
CASGDFNQPQHF	CASGDFNQPQHF	singleton
CASSHVGEKLFF	CASSHVGEKLFF	singleton
CSAETGRHEQYF	CSAETGRHEQYF	singleton
CASSLGTGTASYNEQFF	CASSLGTGTASYNEQFF	singleton
CSARDGGSDEQYF	CSARDGGSDEQYF	singleton
CASSLGEGRATQYF	CASSLGEGRATQYF	singleton
CASSWQGPPDTQYF	CASSWQGPPDTQYF	singleton
CASSFYGTEAFF	CASSFYGTEAFF	singleton
CAIGGPSDQPQHF	CAIGGPSDQPQHF	singleton
CASSLAPVYEQYF	CASSLAPVYEQYF	singleton
CPGTSGGAMNEQFF	CPGTSGGAMNEQFF	singleton
CASTTRPSPHYGYTF	CASTTRPSPHYGYTF	singleton
CASSPLSMGAANYGYTF	CASSPLSMGAANYGYTF	singleton
CASSPPGIEKLFF	CASSPPGIEKLFF	singleton
CSALNRAGTGELFF	CSALNRAGTGELFF	singleton
CASSPGRNQPQHF	CASSPGRNQPQHF	singleton
CASSPPGLAGGDEQFF	CASSPPGLAGGDEQFF	singleton
CASSFLRGEQAKNIQYF	CASSFLRGEQAKNIQYF	singleton
CASTLRDSGEAFF	CASTLRDSGEAFF	singleton
CASSLTGTSGSWYEQYF	CASSLTGTSGSWYEQYF	singleton
CASSYPQNEQFF	CASSYPQNEQFF	singleton
CASSLARAGVGGYTF	CASSLARAGVGGYTF	singleton
CASSVEAGLIYNEQFF	CASSVEAGLIYNEQFF	singleton
CASSGGTGDEQYF	CASSGGTGDEQYF	singleton
CASSPVGAPLGEQYF	CASSPVGAPLGEQYF	singleton
CASKRGDRGNTEAFF	CASKRGDRGNTEAFF	singleton
CASSLGAIEQYF	CASSLGAIEQYF	singleton
CSAWGLAGPSYEQYF	CSAWGLAGPSYEQYF	singleton
CSARSPGQGHEKLFF	CSARSPGQGHEKLFF	singleton
CASGFRGGSGNTIYF	CASGFRGGSGNTIYF	singleton
CASSLVVQGNQPQHF	CASSLVVQGNQPQHF	singleton
CASSLQPGTSEQYF	CASSLQPGTSEQYF	singleton
CAISAAGNTEAFF	CAISAAGNTEAFF	singleton
CASSVQGPDNSPLHF	CASSVQGPDNSPLHF	singleton
CASRGRTGGGIFGGYTF	CASRGRTGGGIFGGYTF	singleton
CASSGTGSSYEQYF	CASSGTGSSYEQYF	singleton
CASSSSRLSYNEQFF	CASSSSRLSYNEQFF	singleton
CASAQGDIQETQYF	CASAQGDIQETQYF	singleton
CASSSSLAGELDNEQFF	CASSSSLAGELDNEQFF	singleton
CASSQAGGSGNTIYF	CASSQAGGSGNTIYF	singleton
CSAREGGQSGTQYF	CSAREGGQSGTQYF	singleton
CASSPEQGQYF	CASSPEQGQYF	singleton
CSATGTGGDTEAFF	CSATGTGGDTEAFF	singleton
CASSQSNGELFF	CASSQSNGELFF	singleton
CSASSESGYEQYF	CSASSESGYEQYF	singleton
CATSPRESNYGYTF	CATSPRESNYGYTF	singleton
CASRTTTGDGETQYF	CASRTTTGDGETQYF	singleton
CASSLFVAGGAHEQYF	CASSLFVAGGAHEQYF	singleton
CASTGGQGLDEQYF	CASTGGQGLDEQYF	singleton
CASSLEGWGGSYNSPLHF	CASSLEGWGGSYNSPLHF	singleton
CASSENQGINQPQHF	CASSENQGINQPQHF	singleton
CSAPPGWGEGYTF	CSAPPGWGEGYTF	singleton
CASSLSTGLQFF	CASSLSTGLQFF	singleton
CASRTGLTNEKLFF	CASRTGLTNEKLFF	singleton
CASSPDRIVEKLFF	CASSPDRIVEKLFF	singleton
CASSGGLNQPQHF	CASSGGLNQPQHF	singleton
CASSFNTDRARSPLHF	CASSFNTDRARSPLHF	singleton
CASSPEVYGYTF	CASSPEVYGYTF	singleton
CASTPTGAPNQPQHF	CASTPTGAPNQPQHF	singleton
CASSYRVSGNTIYF	CASSYRVSGNTIYF	singleton
CASSLTDYGYTF	CASSLTDYGYTF	singleton
CASRFLKGSNTEAFF	CASRFLKGSNTEAFF	singleton
CASRQGLVSGANVLTF	CASRQGLVSGANVLTF	singleton
CSANDNGGGETQYF	CSANDNGGGETQYF	singleton
CASSRTGGSGNTIYF	CASSRTGGSGNTIYF	singleton
CASSYSGGLTNEKLFF	CASSYSGGLTNEKLFF	singleton
CASSLVPTEAFF	CASSLVPTEAFF	singleton
CSAWIAGGPMDEQFF	CSAWIAGGPMDEQFF	singleton
CASSLFWGGGLEKLFF	CASSLFWGGGLEKLFF	singleton
CASSLGQGSRREQYF	CASSLGQGSRREQYF	singleton
CASSPLRSNNEQFF	CASSPLRSNNEQFF	singleton
CASSLGGSTEAFF	CASSLGGSTEAFF	singleton
CATSGFGRSGANVLTF	CATSGFGRSGANVLTF	singleton
CALSKGVNYGYTF	CALSKGVNYGYTF	singleton
CASSQDGTEGDEKLFF	CASSQDGTEGDEKLFF	singleton
CASSLWWGAKNIQYF	CASSLWWGAKNIQYF	singleton
CASSSKASGSVDTQYF	CASSSKASGSVDTQYF	singleton
CASSDGQGFDQPQHF	CASSDGQGFDQPQHF	singleton
CASGPGTSGYNEQFF	CASGPGTSGYNEQFF	singleton
CASSLVGGRQDTQYF	CASSLVGGRQDTQYF	singleton
CASSPSWGLNAGELFF	CASSPSWGLNAGELFF	singleton
CASSAGGALHF	CASSAGGALHF	singleton
CASSSRLPGELFF	CASSSRLPGELFF	singleton
CSAGTTLSGVREQYF	CSAGTTLSGVREQYF	singleton
CASSQVTGSQETQYF	CASSQVTGSQETQYF	singleton
CASRSGQGALVYEQYF	CASRSGQGALVYEQYF	singleton
CASSQGIGGTRAGTGELFF	CASSQGIGGTRAGTGELFF	singleton
CASSAGPAASYNEQFF	CASSAGPAASYNEQFF	singleton
CASSQERREQYF	CASSQERREQYF	singleton
CASSPPGGSLHF	CASSPPGGSLHF	singleton
CASSPSAQRLNTGELFF	CASSPSAQRLNTGELFF	singleton
CASRQTGANSPLHF	CASRQTGANSPLHF	singleton
CASSIGLRAEQYF	CASSIGLRAEQYF	singleton
CASSPTVTGTGAEQYF	CASSPTVTGTGAEQYF	singleton
CASSPGARTTENEQFF	CASSPGARTTENEQFF	singleton
CATSDNDRGELGSEKLFF	CATSDNDRGELGSEKLFF	singleton
CASSLRDRGFSPLHF	CASSLRDRGFSPLHF	singleton
CASRDSERIASPLHF	CASRDSERIASPLHF	singleton
CASTRGPETGELFF	CASTRGPETGELFF	singleton
CASSPQGDTEAFF	CASSPQGDTEAFF	singleton
CSAPGQGRLSGNTIYF	CSAPGQGRLSGNTIYF	singleton
CASSYTGTGNRDNYGYTF	CASSYTGTGNRDNYGYTF	singleton
CASSQGPGNYGYTF	CASSQGPGNYGYTF	singleton
CSVGQNQPQHF	CSVGQNQPQHF	singleton
CASSLGYRTYNEQFF	CASSLGYRTYNEQFF	singleton
CASSPRVSPRANEKLFF	CASSPRVSPRANEKLFF	singleton
CASGLGRGLPVRAEQFF	CASGLGRGLPVRAEQFF	singleton
CAWSPSLAAQGTQYF	CAWSPSLAAQGTQYF	singleton
CASSSPGRNEQYF	CASSSPGRNEQYF	singleton
CASSVVPSAVGAFF	CASSVVPSAVGAFF	singleton
CASSVRGEYGYTF	CASSVRGEYGYTF	singleton
CASSLGGGLREQFF	CASSLGGGLREQFF	singleton
CASSMDGRGEVRETQYF	CASSMDGRGEVRETQYF	singleton
CASSIEAAGTNTGELFF	CASSIEAAGTNTGELFF	singleton
CSARVLNEQFF	CSARVLNEQFF	singleton
CASSTTPATNYGYTF	CASSTTPATNYGYTF	singleton
CASSLGQGASAGANVLTF	CASSLGQGASAGANVLTF	singleton
CASSLGNTGDTEAFF	CASSLGNTGDTEAFF	singleton
CASTTAGTSSYEQYF	CASTTAGTSSYEQYF	singleton
CASSIQALMNTEAFF	CASSIQALMNTEAFF	singleton
CSANDGSSYEQYF	CSANDGSSYEQYF	singleton
CASSSDKRREQYF	CASSSDKRREQYF	singleton
CASSIRTGARTDTQYF	CASSIRTGARTDTQYF	singleton
CSAILPGTGAYNEQFF	CSAILPGTGAYNEQFF	singleton
CASSPGRHNTDTQYF	CASSPGRHNTDTQYF	singleton
CASRQTGPRFNEKLFF	CASRQTGPRFNEKLFF	singleton
CASSLRPVTAANTGELFF	CASSLRPVTAANTGELFF	singleton
CASTLAGGLYEQYF	CASTLAGGLYEQYF	singleton
CSVEQGPGYGYTF	CSVEQGPGYGYTF	singleton
CASSSWTLPTYEQYF	CASSSWTLPTYEQYF	singleton
CATSASLGAGGQRTKEETQYF	CATSASLGAGGQRTKEETQYF	singleton
CASSDAPF	CASSDAPF	singleton
CASSFQGTDTQYF	CASSFQGTDTQYF	singleton
CASSQEPTVKGGNEKLFF	CASSQEPTVKGGNEKLFF	singleton
CASNRGRFDEQYF	CASNRGRFDEQYF	singleton
CAISDARRQGGNTIYF	CAISDARRQGGNTIYF	singleton
CASTSGGETQYF	CASTSGGETQYF	singleton
CSARTSGGLNNEQFF	CSARTSGGLNNEQFF	singleton
CASRSWGTATDTQYF	CASRSWGTATDTQYF	singleton
CASSLAYYEQYF	CASSLAYYEQYF	singleton
CASSIEKTDRGETQYF	CASSIEKTDRGETQYF	singleton
CASSFRQGSYNEQFF	CASSFRQGSYNEQFF	singleton
CSASQGGRSPTQYF	CSASQGGRSPTQYF	singleton
CAWSVLRGRNSPLHF	CAWSVLRGRNSPLHF	singleton
CSARAAGVPYEQYF	CSARAAGVPYEQYF	singleton
CASSLPSGGQDTQYF	CASSLPSGGQDTQYF	singleton
CASSVAPGTTGNEQFF	CASSVAPGTTGNEQFF	singleton
CSATIPDFRSYNEQFF	CSATIPDFRSYNEQFF	singleton
CASSPPGLAGSGTDTQYF	CASSPPGLAGSGTDTQYF	singleton
CASSSTGPVRELFF	CASSSTGPVRELFF	singleton
CASSPRTGGAGNTGELFF	CASSPRTGGAGNTGELFF	singleton
CASSIRGTSGTGELFF	CASSIRGTSGTGELFF	singleton
CASSLGVLGGPREQYF	CASSLGVLGGPREQYF	singleton
CASNSEGVGEQYF	CASNSEGVGEQYF	singleton
CASSLRGGGQGSEQYF	CASSLRGGGQGSEQYF	singleton
CASSVGVRGETQYF	CASSVGVRGETQYF	singleton
CAITEVGGGNQPQHF	CAITEVGGGNQPQHF	singleton
CASSLGWAYEQYF	CASSLGWAYEQYF	singleton
CASRGTKGTQYF	CASRGTKGTQYF	singleton
CASSSLQGNTEAFF	CASSSLQGNTEAFF	singleton
CASSVEGPNNEQFF	CASSVEGPNNEQFF	singleton
CASSLGQFNEQFF	CASSLGQFNEQFF	singleton
CASRATGALGYTF	CASRATGALGYTF	singleton
CASSQIRGGANVLTF	CASSQIRGGANVLTF	singleton
CASRNLGRSIEQFF	CASRNLGRSIEQFF	singleton
CAWNPVGTSSYGYTF	CAWNPVGTSSYGYTF	singleton
CATSATGGYEQYF	CATSATGGYEQYF	singleton
CSAEGSDSAATTRGYTF	CSAEGSDSAATTRGYTF	singleton
CASSWTETLNEQFF	CASSWTETLNEQFF	singleton
CASSVSGQPNQPQHF	CASSVSGQPNQPQHF	singleton
CASSASDRAPNEQFF	CASSASDRAPNEQFF	singleton
CSGGQLNTEAFF	CSGGQLNTEAFF	singleton
CASSGMRARDNEQFF	CASSGMRARDNEQFF	singleton
CASRSTTGRTEAFF	CASRSTTGRTEAFF	singleton
CASSMNQGVKGFF	CASSMNQGVKGFF	singleton
CSAIRGSSYEQYF	CSAIRGSSYEQYF	singleton
CASSKQGAWGNTIYF	CASSKQGAWGNTIYF	singleton
CASSDSQGFLFGYTF	CASSDSQGFLFGYTF	singleton
CASTRGTLSSSYNEQFF	CASTRGTLSSSYNEQFF	singleton
CASSQYRRDRVYGYTF	CASSQYRRDRVYGYTF	singleton
CASSWMLGEASYNEQFF	CASSWMLGEASYNEQFF	singleton
CASSLLKGLFLDTQYF	CASSLLKGLFLDTQYF	singleton
CASSLGRELDQPQHF	CASSLGRELDQPQHF	singleton
CASSPGTGRTGELFF	CASSPGTGRTGELFF	singleton
CASSQERTSNYGYTF	CASSQERTSNYGYTF	singleton
CASTAGPNYGYTF	CASTAGPNYGYTF	singleton
CASSGTTGGLDTQYF	CASSGTTGGLDTQYF	singleton
CATNSGGEGASGANVLTF	CATNSGGEGASGANVLTF	singleton
CASSLENGLLPTDTQYF	CASSLENGLLPTDTQYF	singleton
CASKIEGNTEAFF	CASKIEGNTEAFF	singleton
CASSIQGERGYGYTF	CASSIQGERGYGYTF	singleton
CAISTVPQETQYF	CAISTVPQETQYF	singleton
CAIKEGHQETQYF	CAIKEGHQETQYF	singleton
CASRRTQGASGYTF	CASRRTQGASGYTF	singleton
CASRDDGKLFF	CASRDDGKLFF	singleton
CASTQKGGGGGANYGYTF	CASTQKGGGGGANYGYTF	singleton
CASSIAGSSYNEQFF	CASSIAGSSYNEQFF	singleton
CASSLPGKAADTQYF	CASSLPGKAADTQYF	singleton
CASSTHPGTRFTDTQYF	CASSTHPGTRFTDTQYF	singleton
CSARPPGGLRAEQFF	CSARPPGGLRAEQFF	singleton
CASSRAGQQSNVLTF	CASSRAGQQSNVLTF	singleton
CASSLGALNEQFF	CASSLGALNEQFF	singleton
CASSSLLMNTEAFF	CASSSLLMNTEAFF	singleton
CATSDFGQGSYNEQFF	CATSDFGQGSYNEQFF	singleton
CSAIDSGTAYYEQYF	CSAIDSGTAYYEQYF	singleton
CASSFAGGWVEAFF	CASSFAGGWVEAFF	singleton
CASSCIRDRGNEQYF	CASSCIRDRGNEQYF	singleton
CASTDRTFEAFF	CASTDRTFEAFF	singleton
CASSPSRRSNTEAFF	CASSPSRRSNTEAFF	singleton
CSAVTPTYEQYF	CSAVTPTYEQYF	singleton
CASSLGTGGRSEQFF	CASSLGTGGRSEQFF	singleton
CATSDSGANEQFF	CATSDSGANEQFF	singleton
CASSVEQGTEAFF	CASSVEQGTEAFF	singleton
CASSYASGVWGGTYEQYF	CASSYASGVWGGTYEQYF	singleton
CSAWDRDGYTF	CSAWDRDGYTF	singleton
CASSQDRKAFF	CASSQDRKAFF	singleton
CASSLYASGNTGELFF	CASSLYASGNTGELFF	singleton
CASSLSFLGYTF	CASSLSFLGYTF	singleton
CASSREGKGNQPQHF	CASSREGKGNQPQHF	singleton
CASSPNGRGLGANVLTF	CASSPNGRGLGANVLTF	singleton
CASSPAGDHEQYF	CASSPAGDHEQYF	singleton
CASSNLVSGTEAFF	CASSNLVSGTEAFF	singleton
CASRTDRAQGQPQHF	CASRTDRAQGQPQHF	singleton
CASSRDRGETQYF	CASSRDRGETQYF	singleton
CASSPRQGLAYGYTF	CASSPRQGLAYGYTF	singleton
CSVAGGRGGYNEQFF	CSVAGGRGGYNEQFF	singleton
CASSPRVRIDSNQPQHF	CASSPRVRIDSNQPQHF	singleton
CASSFGTGFSYGYTF	CASSFGTGFSYGYTF	singleton
CASSLDTSYEQYF	CASSLDTSYEQYF	singleton
CAWGKGGHTEAFF	CAWGKGGHTEAFF	singleton
CASTQGLAGSSEQFF	CASTQGLAGSSEQFF	singleton
CASMVGHEQYF	CASMVGHEQYF	singleton
CASSSTGISFTGTLHF	CASSSTGISFTGTLHF	singleton
CAWSPFTPSGYNEQFF	CAWSPFTPSGYNEQFF	singleton
CASSLGAGLYGYTF	CASSLGAGLYGYTF	singleton
CASSLSRTGVNTGELFF	CASSLSRTGVNTGELFF	singleton
CASSYNDYNEQFF	CASSYNDYNEQFF	singleton
CASSGQSLAKNIQYF	CASSGQSLAKNIQYF	singleton
CASEPRAEYSYEQYF	CASEPRAEYSYEQYF	singleton
CASSIVGRGNTEAFF	CASSIVGRGNTEAFF	singleton
CSARLEEGRTNQPQHF	CSARLEEGRTNQPQHF	singleton
CASSPDRFPYEQYF	CASSPDRFPYEQYF	singleton
CASSPPTGTRMGGYTF	CASSPPTGTRMGGYTF	singleton
CASSFGDRVLQPQHF	CASSFGDRVLQPQHF	singleton
CASSPLDRSYGYTF	CASSPLDRSYGYTF	singleton
CASNRQGTTEAFF	CASNRQGTTEAFF	singleton
CASTPGANSNQPQHF	CASTPGANSNQPQHF	singleton
CASSLSGDQPQHF	CASSLSGDQPQHF	singleton
CASSLGGAGGYEQYF	CASSLGGAGGYEQYF	singleton
CASSLGTSGIRANEQFF	CASSLGTSGIRANEQFF	singleton
CASMGQGASPLHF	CASMGQGASPLHF	singleton
CASSLVLAGVDEQFF	CASSLVLAGVDEQFF	singleton
CASSPSIDTQYF	CASSPSIDTQYF	singleton
CAIQLAGVEDTQYF	CAIQLAGVEDTQYF	singleton
CATKDAGETQYF	CATKDAGETQYF	singleton
CASSQESTGSYEQYF	CASSQESTGSYEQYF	singleton
CASSLGRDRDNSPLHF	CASSLGRDRDNSPLHF	singleton
CASSPPLAGTGSYGYTF	CASSPPLAGTGSYGYTF	singleton
CASITEGSGNTIYF	CASITEGSGNTIYF	singleton
CSAKISNQPQHF	CSAKISNQPQHF	singleton
CASSQAGKGTEAFF	CASSQAGKGTEAFF	singleton
CASSLGTRTNEQFF	CASSLGTRTNEQFF	singleton
CATSRAGGLPEQFF	CATSRAGGLPEQFF	singleton
CASSPVSLSNSPLHF	CASSPVSLSNSPLHF	singleton
CASSVAPGGRANVLTF	CASSVAPGGRANVLTF	singleton
CASSPKQGKSPLHF	CASSPKQGKSPLHF	singleton
CASSSPGTGDGNTIYF	CASSSPGTGDGNTIYF	singleton
CASSLGRIFTDTQYF	CASSLGRIFTDTQYF	singleton
CASTPDGHFQETQYF	CASTPDGHFQETQYF	singleton
CAISDTAYEQYF	CAISDTAYEQYF	singleton
CASSQGGLGGDTQYF	CASSQGGLGGDTQYF	singleton
CSTGGTGSGEKLFF	CSTGGTGSGEKLFF	singleton
CASSVELAAKTQYF	CASSVELAAKTQYF	singleton
CASSYGGLGAFF	CASSYGGLGAFF	singleton
CASSLRIQANTEAFF	CASSLRIQANTEAFF	singleton
CASSLLGGNTGELFF	CASSLLGGNTGELFF	singleton
CASSRTGGTGTEAFF	CASSRTGGTGTEAFF	singleton
CASSQDFAATGDGYTF	CASSQDFAATGDGYTF	singleton
CASSLSPLAGNEQYF	CASSLSPLAGNEQYF	singleton
CASSQVPNRGSPLHF	CASSQVPNRGSPLHF	singleton
CASSLGGSVEKLFF	CASSLGGSVEKLFF	singleton
CSASYSNQPQHF	CSASYSNQPQHF	singleton
CASSLKSLAGDYEQYF	CASSLKSLAGDYEQYF	singleton
CASSPSPTGITEAFF	CASSPSPTGITEAFF	singleton
CASSYGNKNEQYF	CASSYGNKNEQYF	singleton
CASSSQGGGQPQHF	CASSSQGGGQPQHF	singleton
CASSLGGRGGTDTQYF	CASSLGGRGGTDTQYF	singleton
CSASDRGVYGYTF	CSASDRGVYGYTF	singleton
CSARDGGSGNTIYF	CSARDGGSGNTIYF	singleton
CASSLGRASGRYSHEQYF	CASSLGRASGRYSHEQYF	singleton
CASRNPDRGGELFF	CASRNPDRGGELFF	singleton
CASSQAWGFKSNEQFF	CASSQAWGFKSNEQFF	singleton
CASSSSGLAEYNEQFF	CASSSSGLAEYNEQFF	singleton
CASSLHGTGGRTGELFF	CASSLHGTGGRTGELFF	singleton
CASSSGQGADTQYF	CASSSGQGADTQYF	singleton
CASSIDFQTKNIQYF	CASSIDFQTKNIQYF	singleton
CASSGTDNTGELFF	CASSGTDNTGELFF	singleton
CASSPRPPSGLNTGELFF	CASSPRPPSGLNTGELFF	singleton
CASRRTGGTEAFF	CASRRTGGTEAFF	singleton
CASSSPPREQFF	CASSSPPREQFF	singleton
CASRSIGGYNSPLHF	CASRSIGGYNSPLHF	singleton
CASSIGQANSPLHF	CASSIGQANSPLHF	singleton
CASSQKPGVNEQFF	CASSQKPGVNEQFF	singleton
CASISSGTTGELFF	CASISSGTTGELFF	singleton
CAWSIDFTGHSYNEQFF	CAWSIDFTGHSYNEQFF	singleton
CASSYGRWGRPDTQYF	CASSYGRWGRPDTQYF	singleton
CASSVDQGPQETQYF	CASSVDQGPQETQYF	singleton
CASSGGQNNQPQHF	CASSGGQNNQPQHF	singleton
CSARPFDQGKGVGNTEAFF	CSARPFDQGKGVGNTEAFF	singleton
CASSPAHKETQYF	CASSPAHKETQYF	singleton
CASSLLPGGYTF	CASSLLPGGYTF	singleton
CASSKGQRFYGYTF	CASSKGQRFYGYTF	singleton
CASSAAGTGSLYGYTF	CASSAAGTGSLYGYTF	singleton
CASSQWGAKNIQYF	CASSQWGAKNIQYF	singleton
CASSDTGVPDTQYF	CASSDTGVPDTQYF	singleton
CASGSEGRAKAQHF	CASGSEGRAKAQHF	singleton
CASIETVHGYTF	CASIETVHGYTF	singleton
CASSLTSVYNEQFF	CASSLTSVYNEQFF	singleton
CSAREPGQGNSPLHF	CSAREPGQGNSPLHF	singleton
CATSGDVSFSNQPQHF	CATSGDVSFSNQPQHF	singleton
CSARTSGRAGTYEQYF	CSARTSGRAGTYEQYF	singleton
CASSSRPGTGLGYTF	CASSSRPGTGLGYTF	singleton
CASSDAAGRRGGELFF	CASSDAAGRRGGELFF	singleton
CASSLTSGRGETQYF	CASSLTSGRGETQYF	singleton
CASSPATGVYNEQFF	CASSPATGVYNEQFF	singleton
CASSARGIRSYEQYF	CASSARGIRSYEQYF	singleton
CASSQDTPNTEAFF	CASSQDTPNTEAFF	singleton
CASSTRTASTDTQYF	CASSTRTASTDTQYF	singleton
CASSLTRDDNEQFF	CASSLTRDDNEQFF	singleton
CASSATSGRAFF	CASSATSGRAFF	singleton
CASSQISGGSYGYTF	CASSQISGGSYGYTF	singleton
CASSLGQEIDEQYF	CASSLGQEIDEQYF	singleton
CASSRLAGGFDTGELFF	CASSRLAGGFDTGELFF	singleton
CSARDPAGAVAPLHF	CSARDPAGAVAPLHF	singleton
CASSTPLTTEAFF	CASSTPLTTEAFF	singleton
CASSFGGTKYNEQFF	CASSFGGTKYNEQFF	singleton
CASSFLAGGPSSYNEQFF	CASSFLAGGPSSYNEQFF	singleton
CASSLVSGQTNSPLHF	CASSLVSGQTNSPLHF	singleton
CASSLGRGLSYEQYF	CASSLGRGLSYEQYF	singleton
CASSLMGAANTEAFF	CASSLMGAANTEAFF	singleton
CASSSGQGLETQYF	CASSSGQGLETQYF	singleton
CASSLDTSSGNTIYF	CASSLDTSSGNTIYF	singleton
CSASTSPNTGELFF	CSASTSPNTGELFF	singleton
CASTVLGTGNTEAFF	CASTVLGTGNTEAFF	singleton
CASSLGRTGAAFF	CASSLGRTGAAFF	singleton
CASSLGQGVSYGYTF	CASSLGQGVSYGYTF	singleton
CASSLSPMDEQFF	CASSLSPMDEQFF	singleton
CAWSVEGQGAQPQHF	CAWSVEGQGAQPQHF	singleton
CASSFLDRGASYEQYF	CASSFLDRGASYEQYF	singleton
CASSEPLSRGYTF	CASSEPLSRGYTF	singleton
CASSYNILWVTNTEAFF	CASSYNILWVTNTEAFF	singleton
CASSQDLVTNTGELFF	CASSQDLVTNTGELFF	singleton
CASTPRGNTEAFF	CASTPRGNTEAFF	singleton
CASSYFRDEQFF	CASSYFRDEQFF	singleton
CASSMTSGPNTGELFF	CASSMTSGPNTGELFF	singleton
CASSSGRGAYNEQFF	CASSSGRGAYNEQFF	singleton
CASSFKRGPYEQYF	CASSFKRGPYEQYF	singleton
CSVRPGSQETQYF	CSVRPGSQETQYF	singleton
CASSYSGASGANVLTF	CASSYSGASGANVLTF	singleton
CASSFSGRKEIGELFF	CASSFSGRKEIGELFF	singleton
CASSPADSNQPQHF	CASSPADSNQPQHF	singleton
CSAFNDRVNEQFF	CSAFNDRVNEQFF	singleton
CASSSLAGGSKTGELFF	CASSSLAGGSKTGELFF	singleton
CASSDLDKPGYTF	CASSDLDKPGYTF	singleton
CASSLQGRQETQYF	CASSLQGRQETQYF	singleton
CASSYGEGRSSGNTIYF	CASSYGEGRSSGNTIYF	singleton
CAWKGVDRPNTEAFF	CAWKGVDRPNTEAFF	singleton
CASSVRDRGTGGELFF	CASSVRDRGTGGELFF	singleton
CASSYSPTSYEQYF	CASSYSPTSYEQYF	singleton
CAWSEGNNQPQHF	CAWSEGNNQPQHF	singleton
CASSQDLGFYGYTF	CASSQDLGFYGYTF	singleton
CATKGLAGVGGELFF	CATKGLAGVGGELFF	singleton
CASSQSGAGGSTGTDTQYF	CASSQSGAGGSTGTDTQYF	singleton
CASLKGGQGGNEQFF	CASLKGGQGGNEQFF	singleton
CASSELSPGYNEQFF	CASSELSPGYNEQFF	singleton
CASSSQPTSGRAKENEQFF	CASSSQPTSGRAKENEQFF	singleton
CAIRGISNEQFF	CAIRGISNEQFF	singleton
CASSLTRLAGGYEQYF	CASSLTRLAGGYEQYF	singleton
CASRNGWGDEQYF	CASRNGWGDEQYF	singleton
CASSSAGGYYGYTF	CASSSAGGYYGYTF	singleton
CASSPGQNNNEQFF	CASSPGQNNNEQFF	singleton
CASSVQWNTEAFF	CASSVQWNTEAFF	singleton
CASSLYYPGQVNNEQFF	CASSLYYPGQVNNEQFF	singleton
CASSQGLGFWRPGTEAFF	CASSQGLGFWRPGTEAFF	singleton
CASSRGSVADTQYF	CASSRGSVADTQYF	singleton
CASSPNVYNEQFF	CASSPNVYNEQFF	singleton
CASSLPSGRGNTGELFF	CASSLPSGRGNTGELFF	singleton
CASSPRDRGGEQYF	CASSPRDRGGEQYF	singleton
CASSPPPGQGYEQYF	CASSPPPGQGYEQYF	singleton
CSASGTYEQETQYF	CSASGTYEQETQYF	singleton
CSARDGGSNQPQHF	CSARDGGSNQPQHF	singleton
CASSQEIKVDTQYF	CASSQEIKVDTQYF	singleton
CSARPSLAGGLTDTQYF	CSARPSLAGGLTDTQYF	singleton
CASSIAGGYGVGNQPQHF	CASSIAGGYGVGNQPQHF	singleton
CASSTGWVSDSYEQYF	CASSTGWVSDSYEQYF	singleton
CSASRDPLIDFSSYNEQFF	CSASRDPLIDFSSYNEQFF	singleton
CASSLTTTGGPGNTIYF	CASSLTTTGGPGNTIYF	singleton
CASSLTEKQETQYF	CASSLTEKQETQYF	singleton
CSARDSGTGTRSNQPQHF	CSARDSGTGTRSNQPQHF	singleton
CSAWGQSYEQYF	CSAWGQSYEQYF	singleton
CSADRAYSNQPQHF	CSADRAYSNQPQHF	singleton
CAWSLGQGPYEQYF	CAWSLGQGPYEQYF	singleton
CASSLAPQGYNSPLHF	CASSLAPQGYNSPLHF	singleton
CASRPDSSSMNTEAFF	CASRPDSSSMNTEAFF	singleton
CSASPQVRGYEQYF	CSASPQVRGYEQYF	singleton
CASSPQVGGGEGYTF	CASSPQVGGGEGYTF	singleton
CASSVDTQYF	CASSVDTQYF	singleton
CASSLGTAPLGYTF	CASSLGTAPLGYTF	singleton
CASSLYRGVANEQFF	CASSLYRGVANEQFF	singleton
CASSSLDSYEQYF	CASSSLDSYEQYF	singleton
CASTHRNEQFF	CASTHRNEQFF	singleton
CASSPPGRDSDTQYF	CASSPPGRDSDTQYF	singleton
CASSLGRGGAQETQYF	CASSLGRGGAQETQYF	singleton
CASTPTGTADYEQYF	CASTPTGTADYEQYF	singleton
CSARRDSYEQYF	CSARRDSYEQYF	singleton
CASSPMTGGPFESDTQYF	CASSPMTGGPFESDTQYF	singleton
CASSVGAGGYNEQFF	CASSVGAGGYNEQFF	singleton
CASSESGGKSADTQYF	CASSESGGKSADTQYF	singleton
CASSQQVSPLHF	CASSQQVSPLHF	singleton
CASSPGTGAPNEKLFF	CASSPGTGAPNEKLFF	singleton
CASSADREETQYF	CASSADREETQYF	singleton
CASSYQPGLTDTQYF	CASSYQPGLTDTQYF	singleton
CSARDLDGVLSYNEQFF	CSARDLDGVLSYNEQFF	singleton
CASSIGAGGRGNQPQHF	CASSIGAGGRGNQPQHF	singleton
CASSRTGVAYEQYF	CASSRTGVAYEQYF	singleton
CAISESPGNTEAFF	CAISESPGNTEAFF	singleton
CATGGAGGALDNEQFF	CATGGAGGALDNEQFF	singleton
CASSQNPTPGTAAFF	CASSQNPTPGTAAFF	singleton
CASSPSLGGTSTGELFF	CASSPSLGGTSTGELFF	singleton
CASSLGQYGYTF	CASSLGQYGYTF	singleton
CASMREKNTEAFF	CASMREKNTEAFF	singleton
CAAGRLYEQYF	CAAGRLYEQYF	singleton
CASKRTEVYEQYF	CASKRTEVYEQYF	singleton
CASSEGWHTEAFF	CASSEGWHTEAFF	singleton
CASSLPLAGPTRDNEQFF	CASSLPLAGPTRDNEQFF	singleton
CASSLRQGGDNSPLHF	CASSLRQGGDNSPLHF	singleton
CASNTGTGVYEQYF	CASNTGTGVYEQYF	singleton
CAGKRGASGLETQYF	CAGKRGASGLETQYF	singleton
CASSIQGYHGYTF	CASSIQGYHGYTF	singleton
CASSPDPGYGYTF	CASSPDPGYGYTF	singleton
CAISARRDRANTEAFF	CAISARRDRANTEAFF	singleton
CASTPTGVFTEAFF	CASTPTGVFTEAFF	singleton
CASSDPSGEYLTDTQYF	CASSDPSGEYLTDTQYF	singleton
CASRTHSNLNYGYTF	CASRTHSNLNYGYTF	singleton
CASSPQTVRNSPLHF	CASSPQTVRNSPLHF	singleton
CSARLNTEAFF	CSARLNTEAFF	singleton
CASHRGYYNEQFF	CASHRGYYNEQFF	singleton
CASSPSPGELFF	CASSPSPGELFF	singleton
CAWLHQDRVGNEQFF	CAWLHQDRVGNEQFF	singleton
CAWNRVDTGELFF	CAWNRVDTGELFF	singleton
CASSFPGRGADTQYF	CASSFPGRGADTQYF	singleton
CASSLGGEDNQPQHF	CASSLGGEDNQPQHF	singleton
CASSGQGENSPLHF	CASSGQGENSPLHF	singleton
CAINRDNLYGYTF	CAINRDNLYGYTF	singleton
CASSLRQGNTGELFF	CASSLRQGNTGELFF	singleton
CASSLVEVGSTDTQYF	CASSLVEVGSTDTQYF	singleton
CASSSLAAGEQYF	CASSSLAAGEQYF	singleton
CASSVDGQDWGWNIQYF	CASSVDGQDWGWNIQYF	singleton
CASSKGQGTNTGELFF	CASSKGQGTNTGELFF	singleton
CASSSSRRTGGYTF	CASSSSRRTGGYTF	singleton
CASSDRGQRNEQFF	CASSDRGQRNEQFF	singleton
CASSPPAHSSYEQYF	CASSPPAHSSYEQYF	singleton
CASYTAGVRAQYF	CASYTAGVRAQYF	singleton
CSVDAGTDTQYF	CSVDAGTDTQYF	singleton
CASSSTRGAYEQYF	CASSSTRGAYEQYF	singleton
CSVVLPYNEQFF	CSVVLPYNEQFF	singleton
CASTDLDGPNSPLHF	CASTDLDGPNSPLHF	singleton
CASSRRGTSYNEQFF	CASSRRGTSYNEQFF	singleton
CASSFYDEQFF	CASSFYDEQFF	singleton
CASSLGPPGQGNSPLHF	CASSLGPPGQGNSPLHF	singleton
CASSFGRTYEQYF	CASSFGRTYEQYF	singleton
CASSHKGGDYNEQFF	CASSHKGGDYNEQFF	singleton
CASRNGQSREAFF	CASRNGQSREAFF	singleton
CASSVDLDTEAFF	CASSVDLDTEAFF	singleton
CASSLRGRGTGELFF	CASSLRGRGTGELFF	singleton
CASSQGYKGPNEQFF	CASSQGYKGPNEQFF	singleton
CASSPQGWDQPQHF	CASSPQGWDQPQHF	singleton
CASSPPSGYYNEQFF	CASSPPSGYYNEQFF	singleton
CASSEFPGGITEAFF	CASSEFPGGITEAFF	singleton
CASKASGGSTDTQYF	CASKASGGSTDTQYF	singleton
CSARRGWGSYNEQFF	CSARRGWGSYNEQFF	singleton
CASSSTGADSPLHF	CASSSTGADSPLHF	singleton
CASSSMRWAYNEQFF	CASSSMRWAYNEQFF	singleton
CASKTSGTDYNEQFF	CASKTSGTDYNEQFF	singleton
CASTQTRLNTEAFF	CASTQTRLNTEAFF	singleton
CASSLGLGHLLNTF	CASSLGLGHLLNTF	singleton
CASSYNRGGYTF	CASSYNRGGYTF	singleton
CAPPSPNTGELFF	CAPPSPNTGELFF	singleton
CSAWGQGVSDTQYF	CSAWGQGVSDTQYF	singleton
CSADGGKSEAFF	CSADGGKSEAFF	singleton
CASSYSPSGDSDTQYF	CASSYSPSGDSDTQYF	singleton
CSVDGLVTEAFF	CSVDGLVTEAFF	singleton
CASSVEGEGGQFF	CASSVEGEGGQFF	singleton
CASSETGLDEQYF	CASSETGLDEQYF	singleton
CSASLSNGYEQYF	CSASLSNGYEQYF	singleton
CADPDRGFHNEQFF	CADPDRGFHNEQFF	singleton
CASSWTSGYEQYF	CASSWTSGYEQYF	singleton
CASSQGAGPPGTDTQYF	CASSQGAGPPGTDTQYF	singleton
CAISVGSAEAFF	CAISVGSAEAFF	singleton
CASSPTDRVGGYTF	CASSPTDRVGGYTF	singleton
CASRSGGGWGTDTQYF	CASRSGGGWGTDTQYF	singleton
CASSTPRKGFSTGELFF	CASSTPRKGFSTGELFF	singleton
CSAPDSGANVLTF	CSAPDSGANVLTF	singleton
CSAPPAAGRYNEQFF	CSAPPAAGRYNEQFF	singleton
CASSQEVDSLGEQYF	CASSQEVDSLGEQYF	singleton
CATSPGRFGYTF	CATSPGRFGYTF	singleton
CASSAGQRLLTF	CASSAGQRLLTF	singleton
CASSVGSGGMGNEQFF	CASSVGSGGMGNEQFF	singleton
CASSAGSGLTWGPQFF	CASSAGSGLTWGPQFF	singleton
CASSLSPTRNEQFF	CASSLSPTRNEQFF	singleton
CASSLAGQGPYEQYF	CASSLAGQGPYEQYF	singleton
CASSFSTGGAEKLFF	CASSFSTGGAEKLFF	singleton
CASRRQGAFGNTIYF	CASRRQGAFGNTIYF	singleton
CASSQEGNSGNTIYF	CASSQEGNSGNTIYF	singleton
CSALPSSYLAGGTDTQYF	CSALPSSYLAGGTDTQYF	singleton
CASSYNDPSGNTIYF	CASSYNDPSGNTIYF	singleton
CACGQSTNEKLFF	CACGQSTNEKLFF	singleton
CASSRDRHTGELFF	CASSRDRHTGELFF	singleton
CASSYESGFSYNEQFF	CASSYESGFSYNEQFF	singleton
CASRSRSGVYNEQFF	CASRSRSGVYNEQFF	singleton
CASILGRLAKEETQYF	CASILGRLAKEETQYF	singleton
CASSRTPGNTIYF	CASSRTPGNTIYF	singleton
CASSQGPGDTTNEKLFF	CASSQGPGDTTNEKLFF	singleton
CASSSIGRASRETQYF	CASSSIGRASRETQYF	singleton
CAWSNYAQGDYGYTF	CAWSNYAQGDYGYTF	singleton
CATSLTGGAMDEQFF	CATSLTGGAMDEQFF	singleton
CASSLIRLAAPYNEQFF	CASSLIRLAAPYNEQFF	singleton
CASSDFRGSNEQFF	CASSDFRGSNEQFF	singleton
CSASGNTREQFF	CSASGNTREQFF	singleton
CASSQVIGRGGTEAFF	CASSQVIGRGGTEAFF	singleton
CASSGGVGEEQYF	CASSGGVGEEQYF	singleton
CASRGGGTDTQYF	CASRGGGTDTQYF	singleton
CASSPGVLAGLELFF	CASSPGVLAGLELFF	singleton
CASSWDVLGELFF	CASSWDVLGELFF	singleton
CASSFPREQVGGEAFF	CASSFPREQVGGEAFF	singleton
CASSLEVVTQYF	CASSLEVVTQYF	singleton
CASSPYISRSGANVLTF	CASSPYISRSGANVLTF	singleton
CASSEPILETQYF	CASSEPILETQYF	singleton
CASSQETGSDTEAFF	CASSQETGSDTEAFF	singleton
CASSYSGSTGETQYF	CASSYSGSTGETQYF	singleton
CASSLVWGATEAFF	CASSLVWGATEAFF	singleton
CASSPDEGGSSYEQYF	CASSPDEGGSSYEQYF	singleton
CRTSGALSTDTQYF	CRTSGALSTDTQYF	singleton
CASSQEEVRLGSTEAFF	CASSQEEVRLGSTEAFF	singleton
CASSEMEAGRYEQYF	CASSEMEAGRYEQYF	singleton
CASSPGRQGFGNYGYTF	CASSPGRQGFGNYGYTF	singleton
CASSQDYRRAPTYNEQFF	CASSQDYRRAPTYNEQFF	singleton
CSVPLTVSFGNTIYF	CSVPLTVSFGNTIYF	singleton
CSASPGLNVETQYF	CSASPGLNVETQYF	singleton
CASSLARYDSSYNEQFF	CASSLARYDSSYNEQFF	singleton
CSARDPSLTDTQYF	CSARDPSLTDTQYF	singleton
CASSVEQGEGPDNEQFF	CASSVEQGEGPDNEQFF	singleton
CAGGASYYGYTF	CAGGASYYGYTF	singleton
CASSRSGGYEQYF	CASSRSGGYEQYF	singleton
CASSRGQRTGELFF	CASSRGQRTGELFF	singleton
CATSNPIAAPSTDTQYF	CATSNPIAAPSTDTQYF	singleton
CASSYSGTGENEQYF	CASSYSGTGENEQYF	singleton
CASSSLNTGELFF	CASSSLNTGELFF	singleton
CASSPDRGSWNTEAFF	CASSPDRGSWNTEAFF	singleton
CASSTYGTQPQHF	CASSTYGTQPQHF	singleton
CASSLDGQANNSPLHF	CASSLDGQANNSPLHF	singleton
CAWRVLAGGPRETQYF	CAWRVLAGGPRETQYF	singleton
CASSPPHRQVPNTEAFF	CASSPPHRQVPNTEAFF	singleton
CASSKTTDSGNTIYF	CASSKTTDSGNTIYF	singleton
CASGQGGVAFF	CASGQGGVAFF	singleton
CATRLAGGPTDTQYF	CATRLAGGPTDTQYF	singleton
CASRSKNEQYF	CASRSKNEQYF	singleton
CASSVTAGLAETQYF	CASSVTAGLAETQYF	singleton
CASSLWTGPRFGEQYF	CASSLWTGPRFGEQYF	singleton
CASSLGGFFLSYTF	CASSLGGFFLSYTF	singleton
CASSPYGGHEQYF	CASSPYGGHEQYF	singleton
CASSVQGAPGTQYF	CASSVQGAPGTQYF	singleton
CASAGLAGGIDTQYF	CASAGLAGGIDTQYF	singleton
CASSLAAGVPDEQFF	CASSLAAGVPDEQFF	singleton
CASKMDRNTGELFF	CASKMDRNTGELFF	singleton
CASSVSAGGLSYEQYF	CASSVSAGGLSYEQYF	singleton
CASSTDQGIGELFF	CASSTDQGIGELFF	singleton
CASRTTDEAFF	CASRTTDEAFF	singleton
CAWIGSENHNGYTF	CAWIGSENHNGYTF	singleton
CASIGAGDANTGELFF	CASIGAGDANTGELFF	singleton
CASSRGGVSGADTQYF	CASSRGGVSGADTQYF	singleton
CASSLSSSGSFETQYF	CASSLSSSGSFETQYF	singleton
CASSSPGNTYEQYF	CASSSPGNTYEQYF	singleton
CASGPGRWTSNEQFF	CASGPGRWTSNEQFF	singleton
CASSHGGTTPYEQYF	CASSHGGTTPYEQYF	singleton
CSVIQTSGRHSSTDTQYF	CSVIQTSGRHSSTDTQYF	singleton
CATNPNRADGYTF	CATNPNRADGYTF	singleton
CASSIDQWGYEQYF	CASSIDQWGYEQYF	singleton
CASSLQGLNEQFF	CASSLQGLNEQFF	singleton
CASRGDRGRNEQYF	CASRGDRGRNEQYF	singleton
CASSEKGTGTEAFF	CASSEKGTGTEAFF	singleton
CASSQEDSAGNTIYF	CASSQEDSAGNTIYF	singleton
CASSLALSADTQYF	CASSLALSADTQYF	singleton
CASSQTTRPGDTQYF	CASSQTTRPGDTQYF	singleton
CASSTGLAASFSYNEQFF	CASSTGLAASFSYNEQFF	singleton
CASSLGLGGYGYTF	CASSLGLGGYGYTF	singleton
CASSSGFLETQYF	CASSSGFLETQYF	singleton
CASSLYPPLKVLNTEAFF	CASSLYPPLKVLNTEAFF	singleton
CASSLAAASSYEQYF	CASSLAAASSYEQYF	singleton
CATKPGQGLIYGYTF	CATKPGQGLIYGYTF	singleton
CATSDLPTGGKTSGANVLTF	CATSDLPTGGKTSGANVLTF	singleton
CASSQEGIAGPYNEQFF	CASSQEGIAGPYNEQFF	singleton
CASSSGTDGYTF	CASSSGTDGYTF	singleton
CASCGRGSGSGELFF	CASCGRGSGSGELFF	singleton
CASSRDGYYGYTF	CASSRDGYYGYTF	singleton
CASSLAVWSGDEQYF	CASSLAVWSGDEQYF	singleton
CASSLLAGTSGRANEQFF	CASSLLAGTSGRANEQFF	singleton
CASSLLGLAGGPYEQYF	CASSLLGLAGGPYEQYF	singleton
CASSLPRDRYSNQPQHF	CASSLPRDRYSNQPQHF	singleton
CSVEPFLNTEAFF	CSVEPFLNTEAFF	singleton
CASSLHGGGAYNEQFF	CASSLHGGGAYNEQFF	singleton
CASSQTGGASTEAFF	CASSQTGGASTEAFF	singleton
CASSIPSAQETQYF	CASSIPSAQETQYF	singleton
CASSFERNTGELFF	CASSFERNTGELFF	singleton
CAWSVRGAGTSTQHF	CAWSVRGAGTSTQHF	singleton
CASRDPRGPGANVLTF	CASRDPRGPGANVLTF	singleton
CASSYNGMNTEAFF	CASSYNGMNTEAFF	singleton
CASSSDTRGQPQHF	CASSSDTRGQPQHF	singleton
CASSESGGSYEQYF	CASSESGGSYEQYF	singleton
CASSYSGLARSSYEQYF	CASSYSGLARSSYEQYF	singleton
CASSSSGGAPGELFF	CASSSSGGAPGELFF	singleton
CASRGAWAGELFF	CASRGAWAGELFF	singleton
CASSIARGLLGANVLTF	CASSIARGLLGANVLTF	singleton
CASSLGQVYGYTF	CASSLGQVYGYTF	singleton
CSARDQGLSNQPQHF	CSARDQGLSNQPQHF	singleton
CASSYPNRDRVSGNEQFF	CASSYPNRDRVSGNEQFF	singleton
CASNERGGFSYEQYF	CASNERGGFSYEQYF	singleton
CASTATSGGLNEQFF	CASTATSGGLNEQFF	singleton
CASSVVAVNYNEQFF	CASSVVAVNYNEQFF	singleton
CASSFERGGPYNEQFF	CASSFERGGPYNEQFF	singleton
CSARLQGTGELFF	CSARLQGTGELFF	singleton
CASSFGRGQETQYF	CASSFGRGQETQYF	singleton
CASSQDTGVNEKLFF	CASSQDTGVNEKLFF	singleton
CASGLGNHNEQFF	CASGLGNHNEQFF	singleton
CASSSGGVGNQPQHF	CASSSGGVGNQPQHF	singleton
CASSEGQGASNEKLFF	CASSEGQGASNEKLFF	singleton
CASSQRTGTNTGELFF	CASSQRTGTNTGELFF	singleton
CASRGWGVGTQYF	CASRGWGVGTQYF	singleton
CSARAQSDTQYF	CSARAQSDTQYF	singleton
CASSLVGQGYEKLFF	CASSLVGQGYEKLFF	singleton
CASTIGGGLTDTQYF	CASTIGGGLTDTQYF	singleton
CASRDPDWNTEAFF	CASRDPDWNTEAFF	singleton
CASSSTTGGIATNEKLFF	CASSSTTGGIATNEKLFF	singleton
CASSLTGGWQPQHF	CASSLTGGWQPQHF	singleton
CASSRVPGQPATNEKLFF	CASSRVPGQPATNEKLFF	singleton
CASTGGLGGLAGGRENEQFF	CASTGGLGGLAGGRENEQFF	singleton
CASSTGTSGGYTDTQYF	CASSTGTSGGYTDTQYF	singleton
CASSRGTNTDTQYF	CASSRGTNTDTQYF	singleton
CASSLIPGQALYGYTF	CASSLIPGQALYGYTF	singleton
CASVDRATVGTEAFF	CASVDRATVGTEAFF	singleton
CASSPPEGTEAFF	CASSPPEGTEAFF	singleton
CASSLGARRTSNEKLFF	CASSLGARRTSNEKLFF	singleton
CASSLGPGGNEQFF	CASSLGPGGNEQFF	singleton
CSAGDRGAINYGYTF	CSAGDRGAINYGYTF	singleton
CASSSDITNYGYTF	CASSSDITNYGYTF	singleton
CASSLGPGDTQYF	CASSLGPGDTQYF	singleton
CASSSGTGRTDTQYF	CASSSGTGRTDTQYF	singleton
CASSFGLAGGYQETQYF	CASSFGLAGGYQETQYF	singleton
CASSWGDRPYEQYF	CASSWGDRPYEQYF	singleton
CASSQDRKREAFF	CASSQDRKREAFF	singleton
CASSRYLAGTEAFF	CASSRYLAGTEAFF	singleton
CASSPGGTVAEQYF	CASSPGGTVAEQYF	singleton
CASSFGTLTGELFF	CASSFGTLTGELFF	singleton
CASSDQAGGRETQYF	CASSDQAGGRETQYF	singleton
CASSQGAKGQETQYF	CASSQGAKGQETQYF	singleton
CSARDPLTTPNIQYF	CSARDPLTTPNIQYF	singleton
CASSEGLRAQSGYTF	CASSEGLRAQSGYTF	singleton
CASSQTGPPMNTEAFF	CASSQTGPPMNTEAFF	singleton
CASLIYRWGSINQPQHF	CASLIYRWGSINQPQHF	singleton
CASSQGILGNQPQHF	CASSQGILGNQPQHF	singleton
CASSLFGGATTGELFF	CASSLFGGATTGELFF	singleton
CASSVESSGNGYTF	CASSVESSGNGYTF	singleton
CASSEGLADSYEQYF	CASSEGLADSYEQYF	singleton
CASSYSSQAKFSGNTIYF	CASSYSSQAKFSGNTIYF	singleton
CASRKDRANVLTF	CASRKDRANVLTF	singleton
CASSPRDIYEQYF	CASSPRDIYEQYF	singleton
CASSLNRGPYGYTF	CASSLNRGPYGYTF	singleton
CASSLNQVSRTGELFF	CASSLNQVSRTGELFF	singleton
CASSRSGDGANVLTF	CASSRSGDGANVLTF	singleton
CASSPTGSLGYTF	CASSPTGSLGYTF	singleton
CSVLGTGILDEQFF	CSVLGTGILDEQFF	singleton
CSAIGGGLLMNTEAFF	CSAIGGGLLMNTEAFF	singleton
CASSLQGGLAGNNEQFF	CASSLQGGLAGNNEQFF	singleton
CASSIGAGTDTQYF	CASSIGAGTDTQYF	singleton
CASSLAGGEQPQHF	CASSLAGGEQPQHF	singleton
CASSYSPNIQYF	CASSYSPNIQYF	singleton
CASGKDLNTEAFF	CASGKDLNTEAFF	singleton
CASSLVSVQDTQYF	CASSLVSVQDTQYF	singleton
CASSRGQTPSFF	CASSRGQTPSFF	singleton
CASSQDRGDAKSGNTIYF	CASSQDRGDAKSGNTIYF	singleton
CAGLSGANVLTF	CAGLSGANVLTF	singleton
CASSKGVGQFF	CASSKGVGQFF	singleton
CASSRRSLYGEKLFF	CASSRRSLYGEKLFF	singleton
CSASGLTGLAFNEQFF	CSASGLTGLAFNEQFF	singleton
CASRPGVRAEKLFF	CASRPGVRAEKLFF	singleton
CASSIGLVTGGVLTF	CASSIGLVTGGVLTF	singleton
CASSEGPGRDF	CASSEGPGRDF	singleton
CASRDRQQPQHF	CASRDRQQPQHF	singleton
CASRRLGGSRGDTQYF	CASRRLGGSRGDTQYF	singleton
CASSLLGQGGNQPQHF	CASSLLGQGGNQPQHF	singleton
CASSVGTAGNTIYF	CASSVGTAGNTIYF	singleton
CASGGTVSNYGYTF	CASGGTVSNYGYTF	singleton
CASSRSKGDSGANVLTF	CASSRSKGDSGANVLTF	singleton
CAISAAGPNTEAFF	CAISAAGPNTEAFF	singleton
CASSGTGGFYEQFF	CASSGTGGFYEQFF	singleton
CASRQYGQGMDEQFF	CASRQYGQGMDEQFF	singleton
CASSDHSKNEQFF	CASSDHSKNEQFF	singleton
CASSYGTGQDEQYF	CASSYGTGQDEQYF	singleton
CASSPDPFGNTGELFF	CASSPDPFGNTGELFF	singleton
CASSQWDRLGEQYF	CASSQWDRLGEQYF	singleton
CASSYRDRGLYEQYF	CASSYRDRGLYEQYF	singleton
CASSHGLSYEQYF	CASSHGLSYEQYF	singleton
CASSLARGQPQHF	CASSLARGQPQHF	singleton
CASSQWAGGTDTQYF	CASSQWAGGTDTQYF	singleton
CASSTETGGLEQYF	CASSTETGGLEQYF	singleton
CASSPGQVTNYGYTF	CASSPGQVTNYGYTF	singleton
CASSSTEAFF	CASSSTEAFF	singleton
CSVGLTGTLGDEQFF	CSVGLTGTLGDEQFF	singleton
CAISESRVGSPLHF	CAISESRVGSPLHF	singleton
CASSVGGKNSPLHF	CASSVGGKNSPLHF	singleton
CSARAFGGAFRETQYF	CSARAFGGAFRETQYF	singleton
CASSSVGTRNTGELFF	CASSSVGTRNTGELFF	singleton
CASHGRTGTFKSYGYTF	CASHGRTGTFKSYGYTF	singleton
CASSPRTSSPREQYF	CASSPRTSSPREQYF	singleton
CASSQTRDRDLAFF	CASSQTRDRDLAFF	singleton
CASSPGYIYGYTF	CASSPGYIYGYTF	singleton
CASSPIRGPLPNTEAFF	CASSPIRGPLPNTEAFF	singleton
CASSKRQGAYNEQFF	CASSKRQGAYNEQFF	singleton
CASSREDNSPLHF	CASSREDNSPLHF	singleton
CASRDDNRGHNQPQHF	CASRDDNRGHNQPQHF	singleton
CASTRRAVNYGYTF	CASTRRAVNYGYTF	singleton
CASSPRTGRAGGGYNEQFF	CASSPRTGRAGGGYNEQFF	singleton
CASSLSVVTDTQYF	CASSLSVVTDTQYF	singleton
CSAQGTSGRYEQYF	CSAQGTSGRYEQYF	singleton
CASSWTGPNQPQHF	CASSWTGPNQPQHF	singleton
CASRLLAETYEQYF	CASRLLAETYEQYF	singleton
CSARLLDRDDNEQFF	CSARLLDRDDNEQFF	singleton
CASSELFVGQPQHF	CASSELFVGQPQHF	singleton
CAWTASSGLRGKLFF	CAWTASSGLRGKLFF	singleton
CASSSIARNEQFF	CASSSIARNEQFF	singleton
CASSSFSGGYNEQFF	CASSSFSGGYNEQFF	singleton
CATSGREDEQYF	CATSGREDEQYF	singleton
CASTPGGRNSPLHF	CASTPGGRNSPLHF	singleton
CASSRTGLTAKNIQYF	CASSRTGLTAKNIQYF	singleton
CASGLYFGTVWF	CASGLYFGTVWF	singleton
CASSARTGGANYGYTF	CASSARTGGANYGYTF	singleton
CAWSGGGGTDTQYF	CAWSGGGGTDTQYF	singleton
CASSIDIGYTF	CASSIDIGYTF	singleton
CASSQIQGEGQPQHF	CASSQIQGEGQPQHF	singleton
CASSQQGTVKNIQYF	CASSQQGTVKNIQYF	singleton
CASSLVPNTEAFF	CASSLVPNTEAFF	singleton
CASSLLGGEQFF	CASSLLGGEQFF	singleton
CASSQDAGDSNQPQHF	CASSQDAGDSNQPQHF	singleton
CALRGAGGTGELFF	CALRGAGGTGELFF	singleton
CASSFLGIEQYF	CASSFLGIEQYF	singleton
CATSTVQGADTEAFF	CATSTVQGADTEAFF	singleton
CASSSLRYNEQFF	CASSSLRYNEQFF	singleton
CASGQTGQGSYEQYF	CASGQTGQGSYEQYF	singleton
CASSEEWGQGYTF	CASSEEWGQGYTF	singleton
CASSEGIPGGMNTEAFF	CASSEGIPGGMNTEAFF	singleton
CASRQGGGSHTEAFF	CASRQGGGSHTEAFF	singleton
CASSDSPVRYEQYF	CASSDSPVRYEQYF	singleton
CASSLRDQPQHF	CASSLRDQPQHF	singleton
CASSPGTASGNTIYF	CASSPGTASGNTIYF	singleton
CASSREVWGSYEQYF	CASSREVWGSYEQYF	singleton
CATSNPPEAFF	CATSNPPEAFF	singleton
CASVGPSSYGYTF	CASVGPSSYGYTF	singleton
CASSRGGASGNTIYF	CASSRGGASGNTIYF	singleton
CASSQDRRGNNEQFF	CASSQDRRGNNEQFF	singleton
CSASSPQIYSNQPQHF	CSASSPQIYSNQPQHF	singleton
CAWSVVGGKNEQFF	CAWSVVGGKNEQFF	singleton
CSARQGADYTF	CSARQGADYTF	singleton
CASSQPPSGSLAGELFF	CASSQPPSGSLAGELFF	singleton
CASSQGAHYEQYF	CASSQGAHYEQYF	singleton
CASSHPPQKTEAFF	CASSHPPQKTEAFF	singleton
CASTPNPGTSLPNEQFF	CASTPNPGTSLPNEQFF	singleton
CASSADRAGNSPLHF	CASSADRAGNSPLHF	singleton
CASSLRTSLGETQYF	CASSLRTSLGETQYF	singleton
CASSQGGGGPQETQYF	CASSQGGGGPQETQYF	singleton
CSARSQYTQYF	CSARSQYTQYF	singleton
CASSLAGTGLSEQYF	CASSLAGTGLSEQYF	singleton
CASSFASGGRAGELFF	CASSFASGGRAGELFF	singleton
CAWRGVIEAFF	CAWRGVIEAFF	singleton
CASSPLQAGYLEAFF	CASSPLQAGYLEAFF	singleton
CASTPPDRDYEQYF	CASTPPDRDYEQYF	singleton
CSASPRVRYEQYF	CSASPRVRYEQYF	singleton
CASSPGGVSVGANVLTF	CASSPGGVSVGANVLTF	singleton
CASSQDPAGVWGYTF	CASSQDPAGVWGYTF	singleton
CASSREPGQSNTEAFF	CASSREPGQSNTEAFF	singleton
CASSDRPNNSPLHF	CASSDRPNNSPLHF	singleton
CASSRDRELGSPLHF	CASSRDRELGSPLHF	singleton
CASSEAIRTPYGYTF	CASSEAIRTPYGYTF	singleton
CASSSQGAYEQYF	CASSSQGAYEQYF	singleton
CASRREVTGNEKLFF	CASRREVTGNEKLFF	singleton
CASSPPTGSTEAFF	CASSPPTGSTEAFF	singleton
CASCAAERADTQYF	CASCAAERADTQYF	singleton
CASSPPGAGAETQYF	CASSPPGAGAETQYF	singleton
CASTLSLFSNQPQHF	CASTLSLFSNQPQHF	singleton
CASSTPERGTGDEQYF	CASSTPERGTGDEQYF	singleton
CASTRREAYSGNTIYF	CASTRREAYSGNTIYF	singleton
CASSRGQLLNTEAFF	CASSRGQLLNTEAFF	singleton
CASSSDPGTGKDGQYF	CASSSDPGTGKDGQYF	singleton
CASSFGGASQYF	CASSFGGASQYF	singleton
CASSTGDSNQPQHF	CASSTGDSNQPQHF	singleton
CASSHNYNEQFF	CASSHNYNEQFF	singleton
CASSLGPPTSGNTIYF	CASSLGPPTSGNTIYF	singleton
CASSVGQGNYGYTF	CASSVGQGNYGYTF	singleton
CASSFAGAANTEAFF	CASSFAGAANTEAFF	singleton
CASFSAGRDTQYF	CASFSAGRDTQYF	singleton
CASSLASGGANVYEQYF	CASSLASGGANVYEQYF	singleton
CATETGANSPLHF	CATETGANSPLHF	singleton
CAWSVLRNEQFF	CAWSVLRNEQFF	singleton
CSARDTSGRPSYNEQFF	CSARDTSGRPSYNEQFF	singleton
CASSLGVGGSMPYEQYF	CASSLGVGGSMPYEQYF	singleton
CASSERGRGNTEAFF	CASSERGRGNTEAFF	singleton
CASSGARARDYQETQYF	CASSGARARDYQETQYF	singleton
CASSIGQGSGYTF	CASSIGQGSGYTF	singleton
CASSNDGPRGGEQFF	CASSNDGPRGGEQFF	singleton
CASSLEGRVQPQHF	CASSLEGRVQPQHF	singleton
CASSATRGEQFF	CASSATRGEQFF	singleton
CASSGQFSSNYGYTF	CASSGQFSSNYGYTF	singleton
CATSRDEDNQPQHF	CATSRDEDNQPQHF	singleton
CASSRQGSEAFF	CASSRQGSEAFF	singleton
CSARSGLTPEENEQFF	CSARSGLTPEENEQFF	singleton
CASRHDRAYEQYF	CASRHDRAYEQYF	singleton
CAWSVGFTLGGYTF	CAWSVGFTLGGYTF	singleton
CSARAGDGGIETQYF	CSARAGDGGIETQYF	singleton
CSARDPTSTDTQYF	CSARDPTSTDTQYF	singleton
CASSEYSSGANVLTF	CASSEYSSGANVLTF	singleton
CASKRGPGGTQYF	CASKRGPGGTQYF	singleton
CASKHGDRAINEQFF	CASKHGDRAINEQFF	singleton
CASIQGQGYETQYF	CASIQGQGYETQYF	singleton
CSASRDSTDTQYF	CSASRDSTDTQYF	singleton
CASSQDGGRTDTQYF	CASSQDGGRTDTQYF	singleton
CASPNRELFYEQYF	CASPNRELFYEQYF	singleton
CATVVLAGGHNEQFF	CATVVLAGGHNEQFF	singleton
CASRPGTSATYLYIQYF	CASRPGTSATYLYIQYF	singleton
CASSLGPGGEETQYF	CASSLGPGGEETQYF	singleton
CASSHQRGGDEQFF	CASSHQRGGDEQFF	singleton
CASSRSGTNTEAFF	CASSRSGTNTEAFF	singleton
CASSLGPGTYEQYF	CASSLGPGTYEQYF	singleton
CANPSGRGGSSGNEQFF	CANPSGRGGSSGNEQFF	singleton
CATHPQDGELFF	CATHPQDGELFF	singleton
CSARGLAGHPYEQYF	CSARGLAGHPYEQYF	singleton
CASSLRSGSFFYSPLHF	CASSLRSGSFFYSPLHF	singleton
CASSLESSYEQYF	CASSLESSYEQYF	singleton
CASSLEPGGSLTNEQFF	CASSLEPGGSLTNEQFF	singleton
CASSDNGGLAVETQYF	CASSDNGGLAVETQYF	singleton
CASSQTGTGTTPLHF	CASSQTGTGTTPLHF	singleton
CASSPRRGGSEKLFF	CASSPRRGGSEKLFF	singleton
CASSFSPGNTIYF	CASSFSPGNTIYF	singleton
CASDRSTDTQYF	CASDRSTDTQYF	singleton
CASSLGVGETQYF	CASSLGVGETQYF	singleton
CASSPKPNQPQHF	CASSPKPNQPQHF	singleton
CASSVVGGRVNEQFF	CASSVVGGRVNEQFF	singleton
CASSIGWDNTEAFF	CASSIGWDNTEAFF	singleton
CASRYRGNNYGYTF	CASRYRGNNYGYTF	singleton
CAWSVGGADQPQHF	CAWSVGGADQPQHF	singleton
CASSYLQGILQPQHF	CASSYLQGILQPQHF	singleton
CSARGPGRYTDTQYF	CSARGPGRYTDTQYF	singleton
CASSPAGSEKLFF	CASSPAGSEKLFF	singleton
CSARAPVDTGELFF	CSARAPVDTGELFF	singleton
CASSQQRSAGPYNEQFF	CASSQQRSAGPYNEQFF	singleton
CATHSGRAGYEQYF	CATHSGRAGYEQYF	singleton
CASSPIGASTEAFF	CASSPIGASTEAFF	singleton
CAWSRGSGANVLTF	CAWSRGSGANVLTF	singleton
CASSPPIAHNERFF	CASSPPIAHNERFF	singleton
CASSPGAQGLNSPLHF	CASSPGAQGLNSPLHF	singleton
CASSSPLLGNTEAFF	CASSSPLLGNTEAFF	singleton
CASSQELSGGADTQYF	CASSQELSGGADTQYF	singleton
CASSLRGSGDMETQYF	CASSLRGSGDMETQYF	singleton
CASSSRGGGNTIYF	CASSSRGGGNTIYF	singleton
CASSFRENTDTQYF	CASSFRENTDTQYF	singleton
CASNSAGPGYEQYF	CASNSAGPGYEQYF	singleton
CASSETGVVTNEKLFF	CASSETGVVTNEKLFF	singleton
CASSGQIENTEAFF	CASSGQIENTEAFF	singleton
CATSDPGTSGRATGELFF	CATSDPGTSGRATGELFF	singleton
CSAERSGRTMNTEAFF	CSAERSGRTMNTEAFF	singleton
CASSDFNEKLFF	CASSDFNEKLFF	singleton
CASSAGQRNQPQHF	CASSAGQRNQPQHF	singleton
CASTTGGEQFF	CASTTGGEQFF	singleton
CASSLDGGHQETQYF	CASSLDGGHQETQYF	singleton
CASSLDPSTDTQYF	CASSLDPSTDTQYF	singleton
CASSKDRGPYNEQFF	CASSKDRGPYNEQFF	singleton
CASRPGTGSGYTF	CASRPGTGSGYTF	singleton
CAWSVAARVYGYTF	CAWSVAARVYGYTF	singleton
CASSQDSRVQETQYF	CASSQDSRVQETQYF	singleton
CASSVTVQSSGNTIYF	CASSVTVQSSGNTIYF	singleton
CASSLGAVKWETQYF	CASSLGAVKWETQYF	singleton
CASSFRDYNEQFF	CASSFRDYNEQFF	singleton
CASSLLGSDNYGYTF	CASSLLGSDNYGYTF	singleton
CSARLRTGSSYNEQFF	CSARLRTGSSYNEQFF	singleton
CASSLRDVRGNQPQHF	CASSLRDVRGNQPQHF	singleton
CASSPTDWGDTEAFF	CASSPTDWGDTEAFF	singleton
CASSRGTSFCL	CASSRGTSFCL	singleton
CASSPTGLSDYGYTF	CASSPTGLSDYGYTF	singleton
CASSQGVITEAFF	CASSQGVITEAFF	singleton
CASTQGVGTDTQYF	CASTQGVGTDTQYF	singleton
CAWTLKGQGYTF	CAWTLKGQGYTF	singleton
CASVSGADEQFF	CASVSGADEQFF	singleton
CASRLAGGLGGELFF	CASRLAGGLGGELFF	singleton
CASSPGQGVWTEAFF	CASSPGQGVWTEAFF	singleton
CSARRPGQTYEQYF	CSARRPGQTYEQYF	singleton
CASTPTGALNTQYF	CASTPTGALNTQYF	singleton
CASRERGSYEQYF	CASRERGSYEQYF	singleton
CSADSSGNTIYF	CSADSSGNTIYF	singleton
CASSQVAGGPYEQYF	CASSQVAGGPYEQYF	singleton
CATSSIRGGELFF	CATSSIRGGELFF	singleton
CASSYWGSEGAFF	CASSYWGSEGAFF	singleton
CASSGDRGREKLFF	CASSGDRGREKLFF	singleton
CASSYGVEGTLHF	CASSYGVEGTLHF	singleton
CASSPNTRLMAEAFF	CASSPNTRLMAEAFF	singleton
CASSPALLSNTIYF	CASSPALLSNTIYF	singleton
CASSDEGSSGGHTDTQYF	CASSDEGSSGGHTDTQYF	singleton
CASSPRTSGSYEQYF	CASSPRTSGSYEQYF	singleton
CASSLVLAIYNEQFF	CASSLVLAIYNEQFF	singleton
CASHSTGRGGSYEQYF	CASHSTGRGGSYEQYF	singleton
CASSRGQTVETQYF	CASSRGQTVETQYF	singleton
CASSLRITGELFF	CASSLRITGELFF	singleton
CASSLFGGSNGNTIYF	CASSLFGGSNGNTIYF	singleton
CASPRRHPSSGANVLTF	CASPRRHPSSGANVLTF	singleton
CASSLGGSGNTIYF	CASSLGGSGNTIYF	singleton
CSAPGTGIRGGYTF	CSAPGTGIRGGYTF	singleton
CASRGPRTSLLDTQYF	CASRGPRTSLLDTQYF	singleton
CASSPVPGPNTEAFF	CASSPVPGPNTEAFF	singleton
CASRPHRGRFNTEAFF	CASRPHRGRFNTEAFF	singleton
CASSSGGEMNTEAFF	CASSSGGEMNTEAFF	singleton
CASSDPKAIAGTRGNPLF	CASSDPKAIAGTRGNPLF	singleton
CASSNRGYEQYF	CASSNRGYEQYF	singleton
CASSLLRGRTDTQYF	CASSLLRGRTDTQYF	singleton
CASSSTGVYTEAFF	CASSSTGVYTEAFF	singleton
CASSERYEQYF	CASSERYEQYF	singleton
CATRDRGNQPQHF	CATRDRGNQPQHF	singleton
CASSDGLAGGRRNEQFF	CASSDGLAGGRRNEQFF	singleton
CASSFNMWPQHF	CASSFNMWPQHF	singleton
CASSEKGQAHYEQYF	CASSEKGQAHYEQYF	singleton
CSAREASAGTDTQYF	CSAREASAGTDTQYF	singleton
CSANLAGEPRDTQYF	CSANLAGEPRDTQYF	singleton
CASSQDRAAAYNEQFF	CASSQDRAAAYNEQFF	singleton
CSASTSGQFF	CSASTSGQFF	singleton
CASSLGPSNYGYTF	CASSLGPSNYGYTF	singleton
CASSIEDRVTDTQYF	CASSIEDRVTDTQYF	singleton
CASSLDDSRNQPQHF	CASSLDDSRNQPQHF	singleton
CASSPDRATEAFF	CASSPDRATEAFF	singleton
CASAADSKNIQYF	CASAADSKNIQYF	singleton
CASSLGGNYYEQYF	CASSLGGNYYEQYF	singleton
CASSSAGALQETQYF	CASSSAGALQETQYF	singleton
CAISEDRKSYEQYF	CAISEDRKSYEQYF	singleton
CASSLYGGEGYEQYF	CASSLYGGEGYEQYF	singleton
CASSLSGGRNQPQHF	CASSLSGGRNQPQHF	singleton
CASRGLPSPWVGELFF	CASRGLPSPWVGELFF	singleton
CASSLVASSGNTIYF	CASSLVASSGNTIYF	singleton
CASSPLPPIGNQPQHF	CASSPLPPIGNQPQHF	singleton
CASSPGLDQPQHF	CASSPGLDQPQHF	singleton
CASYDNDLAKNIQYF	CASYDNDLAKNIQYF	singleton
CATSDLFQGTDTQYF	CATSDLFQGTDTQYF	singleton
CASSSAGADITDTQYF	CASSSAGADITDTQYF	singleton
CASSYSTEDNEKLFF	CASSYSTEDNEKLFF	singleton
CSVNAGFSLNEQFF	CSVNAGFSLNEQFF	singleton
CASSGGFGGNTEAFF	CASSGGFGGNTEAFF	singleton
CASSLDFGRAKNIQYF	CASSLDFGRAKNIQYF	singleton
CASSLAAAGGNQPQHF	CASSLAAAGGNQPQHF	singleton
CASSEGQGKTDTQYF	CASSEGQGKTDTQYF	singleton
CASRLSWTGGPDTQYF	CASRLSWTGGPDTQYF	singleton
CSAREGWGELFF	CSAREGWGELFF	singleton
CASSLRGGPSYEQYF	CASSLRGGPSYEQYF	singleton
CASSLAGLAKNIQYF	CASSLAGLAKNIQYF	singleton
CASSLRYTDTQYF	CASSLRYTDTQYF	singleton
CASSLPGNTEAFF	CASSLPGNTEAFF	singleton
CASSLYSGGPYEQYF	CASSLYSGGPYEQYF	singleton
CASSVGRGSEAFF	CASSVGRGSEAFF	singleton
CASSQVGDYGYTF	CASSQVGDYGYTF	singleton
CASRPMGGQSGYTF	CASRPMGGQSGYTF	singleton
CASSLQGQGSGNTIYF	CASSLQGQGSGNTIYF	singleton
CSARVDRGVGQFNYGYTF	CSARVDRGVGQFNYGYTF	singleton
CASSLQDSINEQFF	CASSLQDSINEQFF	singleton
CASLKGNQQFF	CASLKGNQQFF	singleton
CSPLSGTAKSYNEQFF	CSPLSGTAKSYNEQFF	singleton
CASSEYGGGNTEAFF	CASSEYGGGNTEAFF	singleton
CASSPGTQVSGANVLTF	CASSPGTQVSGANVLTF	singleton
CASSRGTGATSGANVLTF	CASSRGTGATSGANVLTF	singleton
CASSHGDRTSYEKLFF	CASSHGDRTSYEKLFF	singleton
CASREGPYSGNTIYF	CASREGPYSGNTIYF	singleton
CASSPQTRGQGGQETQYF	CASSPQTRGQGGQETQYF	singleton
CASSEALGGLSGANVLTF	CASSEALGGLSGANVLTF	singleton
CASSLLGAGDGYTF	CASSLLGAGDGYTF	singleton
CAWSVRGTGRSPLHF	CAWSVRGTGRSPLHF	singleton
CASSLKSGTSTDTQYF	CASSLKSGTSTDTQYF	singleton
CASSVAGVSADTQYF	CASSVAGVSADTQYF	singleton
CASSYRQGSTEAFF	CASSYRQGSTEAFF	singleton
CASSSYSDNQPQHF	CASSSYSDNQPQHF	singleton
CASSSQGAYNSPLHF	CASSSQGAYNSPLHF	singleton
CASSASSWGEQYF	CASSASSWGEQYF	singleton
CASSLRSDGFDEQFF	CASSLRSDGFDEQFF	singleton
CASSLSPTSGAFTDTQYF	CASSLSPTSGAFTDTQYF	singleton
CASSPPGSSSYEQYF	CASSPPGSSSYEQYF	singleton
CASSQGGRGAFF	CASSQGGRGAFF	singleton
CASSLGFMEGSKNYGYTF	CASSLGFMEGSKNYGYTF	singleton
CASSYLADETQYF	CASSYLADETQYF	singleton
CAWLGGLTGELFF	CAWLGGLTGELFF	singleton
CASSQDRDQPQHF	CASSQDRDQPQHF	singleton
CASSDAGLGNTIYF	CASSDAGLGNTIYF	singleton
CASSEQSRGLHSPLHF	CASSEQSRGLHSPLHF	singleton
CASSPKESNNSPLHF	CASSPKESNNSPLHF	singleton
CASSYSWGNEQFF	CASSYSWGNEQFF	singleton
CASSPEASGNTIYF	CASSPEASGNTIYF	singleton
CASSGAGVNEQFF	CASSGAGVNEQFF	singleton
CASSMGFQPQHF	CASSMGFQPQHF	singleton
CASSLAGTSGETQYF	CASSLAGTSGETQYF	singleton
CASGLGGGSSTGELFF	CASGLGGGSSTGELFF	singleton
CATSDLSGQPQHF	CATSDLSGQPQHF	singleton
CASSLRQGHEQYF	CASSLRQGHEQYF	singleton
CASAWYSQVDTQYF	CASAWYSQVDTQYF	singleton
CASTPGTSGSLNTGELFF	CASTPGTSGSLNTGELFF	singleton
CASSDERRGTGELFF	CASSDERRGTGELFF	singleton
CSAPKLAGGTNTGELFF	CSAPKLAGGTNTGELFF	singleton
CASSAQSGNDEQFF	CASSAQSGNDEQFF	singleton
CASSEIGTGLYEQYF	CASSEIGTGLYEQYF	singleton
CASSHPGDRANYGYTF	CASSHPGDRANYGYTF	singleton
CASSSGSGTQYNEQFF	CASSSGSGTQYNEQFF	singleton
CSARDRGGRVGYTF	CSARDRGGRVGYTF	singleton
CASSSPPGGHWNYGYTF	CASSSPPGGHWNYGYTF	singleton
CASSYRDKNTEAFF	CASSYRDKNTEAFF	singleton
CASSTGGTQYF	CASSTGGTQYF	singleton
CALELDRGLYGYTF	CALELDRGLYGYTF	singleton
CATSREWGGTDTQYF	CATSREWGGTDTQYF	singleton
CASSSTGVMVAFF	CASSSTGVMVAFF	singleton
CASSPGGGSTQYF	CASSPGGGSTQYF	singleton
CASSQGSRTGGVRTEAFF	CASSQGSRTGGVRTEAFF	singleton
CASSLGRVGEQYF	CASSLGRVGEQYF	singleton
CATSDSMGQPQHF	CATSDSMGQPQHF	singleton
CASSLGKQGTGQETQYF	CASSLGKQGTGQETQYF	singleton
CASSSLWGAEAFF	CASSSLWGAEAFF	singleton
CASSLDPGLADTQYF	CASSLDPGLADTQYF	singleton
CASSPTATAGKLFF	CASSPTATAGKLFF	singleton
CASLRAASGSGEQFF	CASLRAASGSGEQFF	singleton
CASSLVQERQQYF	CASSLVQERQQYF	singleton
CASSYSLQALTDTQYF	CASSYSLQALTDTQYF	singleton
CASSEGPGKQYGYTF	CASSEGPGKQYGYTF	singleton
CASSLAGPDGSGVVIQYF	CASSLAGPDGSGVVIQYF	singleton
CASESLYEQYF	CASESLYEQYF	singleton
CASTKGGTGNEKLFF	CASTKGGTGNEKLFF	singleton
CATSDRPPGSSGYTF	CATSDRPPGSSGYTF	singleton
CASSFDRGRFYGYTF	CASSFDRGRFYGYTF	singleton
CSASGGTRRYEQYF	CSASGGTRRYEQYF	singleton
CASSAASYGTQYF	CASSAASYGTQYF	singleton
CASSLGQGGSNEKLFF	CASSLGQGGSNEKLFF	singleton
CATKPGGIAKNIQYF	CATKPGGIAKNIQYF	singleton
CASSLKGTGGLAGANVLTF	CASSLKGTGGLAGANVLTF	singleton
CSVGTGPKGYTF	CSVGTGPKGYTF	singleton
CASSPTGSNQPQHF	CASSPTGSNQPQHF	singleton
CASIAGWTGELFF	CASIAGWTGELFF	singleton
CASSDGPGGYTF	CASSDGPGGYTF	singleton
CSAPKGKTSGRDGNEQFF	CSAPKGKTSGRDGNEQFF	singleton
CASSFPRAIYSNQPQHF	CASSFPRAIYSNQPQHF	singleton
CASSGGLEAFF	CASSGGLEAFF	singleton
CASNPLRGRSESPGELFF	CASNPLRGRSESPGELFF	singleton
CASSLDRGREDGYTF	CASSLDRGREDGYTF	singleton
CASSFEQMNTEAFF	CASSFEQMNTEAFF	singleton
CAWGMGGTGNTIYF	CAWGMGGTGNTIYF	singleton
CASAPGVESRNEKLFF	CASAPGVESRNEKLFF	singleton
CASSLGPAGNTEAFF	CASSLGPAGNTEAFF	singleton
CASSPLPREWDTGELFF	CASSPLPREWDTGELFF	singleton
CASSVGGSGYGTEAFF	CASSVGGSGYGTEAFF	singleton
CASSRTSGPTRRETQYF	CASSRTSGPTRRETQYF	singleton
CASSVIGGSTEAFF	CASSVIGGSTEAFF	singleton
CASSLPGQGYRESYNEQFF	CASSLPGQGYRESYNEQFF	singleton
CSALGTGDGYTF	CSALGTGDGYTF	singleton
CASTPTGAPNEKLFF	CASTPTGAPNEKLFF	singleton
CASSSHYYEQYF	CASSSHYYEQYF	singleton
CSAISSSGTYEQYF	CSAISSSGTYEQYF	singleton
CASSLPMSSGNTIYF	CASSLPMSSGNTIYF	singleton
CASSTNSNQPQHF	CASSTNSNQPQHF	singleton
CASSLLTASYEQYF	CASSLLTASYEQYF	singleton
CASSEDPGGWMAEAFF	CASSEDPGGWMAEAFF	singleton
CASSFRQATEAFF	CASSFRQATEAFF	singleton
CASSQASSAGGARTQYF	CASSQASSAGGARTQYF	singleton
CASSPQAVGTNEKLFF	CASSPQAVGTNEKLFF	singleton
CASSRGSRGSGNIQYF	CASSRGSRGSGNIQYF	singleton
CASSLSGSLNTEAFF	CASSLSGSLNTEAFF	singleton
CASSSRGQGSNQPQHF	CASSSRGQGSNQPQHF	singleton
CASSSLQGAYDF	CASSSLQGAYDF	singleton
CASTGSGSGETQYF	CASTGSGSGETQYF	singleton
CASSQDRGGVGTEAFF	CASSQDRGGVGTEAFF	singleton
CASSQSPGTWTDTQYF	CASSQSPGTWTDTQYF	singleton
CSASRAGGVYNEQFF	CSASRAGGVYNEQFF	singleton
CASSWRSGSYEQYF	CASSWRSGSYEQYF	singleton
CASSQVGGGTSYEQYF	CASSQVGGGTSYEQYF	singleton
CASNPLWGSNYGYTF	CASNPLWGSNYGYTF	singleton
CSAGQGGFHNEQFF	CSAGQGGFHNEQFF	singleton
CSPASGNKRQPQHF	CSPASGNKRQPQHF	singleton
CASSVGASGIADTQYF	CASSVGASGIADTQYF	singleton
CASSRSGEVTTEAFF	CASSRSGEVTTEAFF	singleton
CSARIMGQGTDTQYF	CSARIMGQGTDTQYF	singleton
CSARDLGGAYNEQFF	CSARDLGGAYNEQFF	singleton
CASSHEPTSGGAGGELFF	CASSHEPTSGGAGGELFF	singleton
CASSSPTGPWPGELFF	CASSSPTGPWPGELFF	singleton
CSARTGLYEQYF	CSARTGLYEQYF	singleton
CASRMDRGRDSPLHF	CASRMDRGRDSPLHF	singleton
CASRGTGKTDEQYF	CASRGTGKTDEQYF	singleton
CASSPDSYEQYF	CASSPDSYEQYF	singleton
CASSELGLAGGDNEQFF	CASSELGLAGGDNEQFF	singleton
CASRRLAGQETQYF	CASRRLAGQETQYF	singleton
CASRATGEGYGYTF	CASRATGEGYGYTF	singleton
CASSLTSEQETQYF	CASSLTSEQETQYF	singleton
CSARPQIADNEQFF	CSARPQIADNEQFF	singleton
CSAEQGGNEKLFF	CSAEQGGNEKLFF	singleton
CASSPDLNQETQYF	CASSPDLNQETQYF	singleton
CASNGVGRETQYF	CASNGVGRETQYF	singleton
CASSHGGSRGGRTEAFF	CASSHGGSRGGRTEAFF	singleton
CASRRGTTQNTGELFF	CASRRGTTQNTGELFF	singleton
CASSPRREYNEQFF	CASSPRREYNEQFF	singleton
CASSVEGAGGPSQETQYF	CASSVEGAGGPSQETQYF	singleton
CASSSGLAELDTQYF	CASSSGLAELDTQYF	singleton
CASGPGQAGNQPQHF	CASGPGQAGNQPQHF	singleton
CASSYSNRVGQGVTGELFF	CASSYSNRVGQGVTGELFF	singleton
CASSLEAYAGLDTQYF	CASSLEAYAGLDTQYF	singleton
CASRGQYSGNTIYF	CASRGQYSGNTIYF	singleton
CASSTGQVGYGYTF	CASSTGQVGYGYTF	singleton
CASSQSRGKAFF	CASSQSRGKAFF	singleton
CASSPTQWSRGEQYF	CASSPTQWSRGEQYF	singleton
CASSLRENTEAFF	CASSLRENTEAFF	singleton
CAVAGTRYQPQHF	CAVAGTRYQPQHF	singleton
CASSPTTGRTDTQYF	CASSPTTGRTDTQYF	singleton
CASSLDPVSYNEQFF	CASSLDPVSYNEQFF	singleton
CASSLPGSPTEAFF	CASSLPGSPTEAFF	singleton
CATSRAGTSYEQYF	CATSRAGTSYEQYF	singleton
CASSPQGQGSSYEQYF	CASSPQGQGSSYEQYF	singleton
CASTWDPRNTEAFF	CASTWDPRNTEAFF	singleton
CASSFPSLGGNEQFF	CASSFPSLGGNEQFF	singleton
CASETGLNTEAFF	CASETGLNTEAFF	singleton
CATSIGGSGENEQYF	CATSIGGSGENEQYF	singleton
CASSWSVYGEDEQYF	CASSWSVYGEDEQYF	singleton
CASTFGQGEGETQYF	CASTFGQGEGETQYF	singleton
CASSHSTGKSYDEYF	CASSHSTGKSYDEYF	singleton
CASSLAREADTQYF	CASSLAREADTQYF	singleton
CASKAGGPTDTQYF	CASKAGGPTDTQYF	singleton
CASSEGATRGYTF	CASSEGATRGYTF	singleton
CASSLDIPGQGLEQYF	CASSLDIPGQGLEQYF	singleton
CSAQQGLNYEQYF	CSAQQGLNYEQYF	singleton
CATSDASRGAGGGPDTQYF	CATSDASRGAGGGPDTQYF	singleton
CASKQGRQTGELFF	CASKQGRQTGELFF	singleton
CASGLAPRGSGEQYF	CASGLAPRGSGEQYF	singleton
CASNPGTGVRNSPLHF	CASNPGTGVRNSPLHF	singleton
CAWSVQGVGYTF	CAWSVQGVGYTF	singleton
CASSLGSPGYSGNTIYF	CASSLGSPGYSGNTIYF	singleton
CASSLGATSVYEQYF	CASSLGATSVYEQYF	singleton
CASSQGPIRSYEQYF	CASSQGPIRSYEQYF	singleton
CASSSQLAGELFF	CASSSQLAGELFF	singleton
CASGLRGQGGTGELFF	CASGLRGQGGTGELFF	singleton
CASSYFLEAEQFF	CASSYFLEAEQFF	singleton
CAWSLGAGARETQYF	CAWSLGAGARETQYF	singleton
CASSLTGQGYNEQFF	CASSLTGQGYNEQFF	singleton
CAWSVRTAGNTEAFF	CAWSVRTAGNTEAFF	singleton
CASSLIAGGEAFF	CASSLIAGGEAFF	singleton
CASRKSGFSTDTQYF	CASRKSGFSTDTQYF	singleton
CSASLQGEKLFF	CSASLQGEKLFF	singleton
CASSPTSGGPGGYNEQFF	CASSPTSGGPGGYNEQFF	singleton
CASSTTETGDTQYF	CASSTTETGDTQYF	singleton
CASSPTIAGAANEQFF	CASSPTIAGAANEQFF	singleton
CASSRLGESSYEQYF	CASSRLGESSYEQYF	singleton
CASSSDPGQKNGYTF	CASSSDPGQKNGYTF	singleton
CASSVSGTLYEQYF	CASSVSGTLYEQYF	singleton
CASSEWDRGPEYTEAFF	CASSEWDRGPEYTEAFF	singleton
CASSLEGEAAGELFF	CASSLEGEAAGELFF	singleton
CASSDATGKNSPLHF	CASSDATGKNSPLHF	singleton
CASSYWDSNQPQHF	CASSYWDSNQPQHF	singleton
CASSPQLAGGYNEQFF	CASSPQLAGGYNEQFF	singleton
CSVVPGDTYEQYF	CSVVPGDTYEQYF	singleton
CATKEGGARYNEQFF	CATKEGGARYNEQFF	singleton
CASSLSRVSHEQYF	CASSLSRVSHEQYF	singleton
CASSLTSYNEQFF	CASSLTSYNEQFF	singleton
CAWSVGVTPFSYNEQFF	CAWSVGVTPFSYNEQFF	singleton
CASSPRDTDNEQFF	CASSPRDTDNEQFF	singleton
CASSEGGAVGTGELFF	CASSEGGAVGTGELFF	singleton
CASSSTRTVSPLHF	CASSSTRTVSPLHF	singleton
CSVEDPTQGGTGNTIYF	CSVEDPTQGGTGNTIYF	singleton
CASSHQTSGGRVGNEQFF	CASSHQTSGGRVGNEQFF	singleton
CASSGGPGQPQHF	CASSGGPGQPQHF	singleton
CASSYRRGGLQETQYF	CASSYRRGGLQETQYF	singleton
CASSSQGPNSPLHF	CASSSQGPNSPLHF	singleton
CASSLEVAGGQETQYF	CASSLEVAGGQETQYF	singleton
CASNRDVKGPQHF	CASNRDVKGPQHF	singleton
CASSPGLAGAVEQFF	CASSPGLAGAVEQFF	singleton
CASGRGGELNEQFF	CASGRGGELNEQFF	singleton
CASTDRIFYEQYF	CASTDRIFYEQYF	singleton
CASSSGYGATEAFF	CASSSGYGATEAFF	singleton
CASRIAQGEQYF	CASRIAQGEQYF	singleton
CASGGGLLGPQHF	CASGGGLLGPQHF	singleton
CSVVGGMGGYEQYF	CSVVGGMGGYEQYF	singleton
CASSDPTGGYGYTF	CASSDPTGGYGYTF	singleton
CASSPQGQGREKLFF	CASSPQGQGREKLFF	singleton
CASSRPGMNTEAFF	CASSRPGMNTEAFF	singleton
CASSYADPVTDTQYF	CASSYADPVTDTQYF	singleton
CASGSRLQGGTEAFF	CASGSRLQGGTEAFF	singleton
CASSLTGEYGYTF	CASSLTGEYGYTF	singleton
CATSGGTGKSGGYTF	CATSGGTGKSGGYTF	singleton
CASSSEGSTYEQYF	CASSSEGSTYEQYF	singleton
CASSIWVGQSNQPQHF	CASSIWVGQSNQPQHF	singleton
CASSFGGAYSPLHF	CASSFGGAYSPLHF	singleton
CASTLSGGGTDTQYF	CASTLSGGGTDTQYF	singleton
CATSRGGATNTGELFF	CATSRGGATNTGELFF	singleton
CASKGGGADFTDTQYF	CASKGGGADFTDTQYF	singleton
CATRAPAWETQYF	CATRAPAWETQYF	singleton
CASSLEGLAGGSEQFF	CASSLEGLAGGSEQFF	singleton
CASSTTGGFPGYTF	CASSTTGGFPGYTF	singleton
CASSLVNPHNEQFF	CASSLVNPHNEQFF	singleton
CASSSQDRGNSPLHF	CASSSQDRGNSPLHF	singleton
CASGFPGGEAFF	CASGFPGGEAFF	singleton
CASSFQPLSEIVGELFF	CASSFQPLSEIVGELFF	singleton
CASSMGGNYEQYF	CASSMGGNYEQYF	singleton
CASNPRGARSYEQYF	CASNPRGARSYEQYF	singleton
CASSPRGGSGANVLTF	CASSPRGGSGANVLTF	singleton
CASSQGPNTGELFF	CASSQGPNTGELFF	singleton
CASSERAANLGQYF	CASSERAANLGQYF	singleton
CASSYPQGTEAFF	CASSYPQGTEAFF	singleton
CASSNNPRDSLSGNTIYF	CASSNNPRDSLSGNTIYF	singleton
CASSPIRVNYGYTF	CASSPIRVNYGYTF	singleton
CASRGAGSYNEQFF	CASRGAGSYNEQFF	singleton
CASSESRAGSTDTQYF	CASSESRAGSTDTQYF	singleton
CASSMGQKQETQYF	CASSMGQKQETQYF	singleton
CASSLGDTTSSPLHF	CASSLGDTTSSPLHF	singleton
CASSLSPDRTYEQYF	CASSLSPDRTYEQYF	singleton
CASSIGSGIGAPEAFF	CASSIGSGIGAPEAFF	singleton
CSVEPQGVNTIYF	CSVEPQGVNTIYF	singleton
CASSPLTGYNGYTF	CASSPLTGYNGYTF	singleton
CASSVAWGIAEKLFF	CASSVAWGIAEKLFF	singleton
CASSPSPHNEQFF	CASSPSPHNEQFF	singleton
CASSLETGPVYEQYF	CASSLETGPVYEQYF	singleton
CSAWGFNQPQHF	CSAWGFNQPQHF	singleton
CASSYRTLKDTGELFF	CASSYRTLKDTGELFF	singleton
CASRNRDRRNRYQPQHF	CASRNRDRRNRYQPQHF	singleton
CSARAEGGTEAFF	CSARAEGGTEAFF	singleton
CASSVQWGAGEKLFF	CASSVQWGAGEKLFF	singleton
CASSAGGNQPQHF	CASSAGGNQPQHF	singleton
CASSTDSGTGGLGYTF	CASSTDSGTGGLGYTF	singleton
CASRPGTTMTGELFF	CASRPGTTMTGELFF	singleton
CASSFQTTGGGGYF	CASSFQTTGGGGYF	singleton
CASSYWEYEQYF	CASSYWEYEQYF	singleton
CSVVTGVAYNEQFF	CSVVTGVAYNEQFF	singleton
CASSLLASNQPQHF	CASSLLASNQPQHF	singleton
CSAKLGQPQHF	CSAKLGQPQHF	singleton
CASSEIYSGPQKTEAFF	CASSEIYSGPQKTEAFF	singleton
CSAPLRGGRTEAFF	CSAPLRGGRTEAFF	singleton
CASSLFNLQHF	CASSLFNLQHF	singleton
CASSQQGLIGYTF	CASSQQGLIGYTF	singleton
CAGTGLAGASSYNEQFF	CAGTGLAGASSYNEQFF	singleton
CASGLDRGLSSYEQYF	CASGLDRGLSSYEQYF	singleton
CASSPMTSFNEQFF	CASSPMTSFNEQFF	singleton
CSVPGQGANGYTF	CSVPGQGANGYTF	singleton
CASSFPSPTSGSFADTQYF	CASSFPSPTSGSFADTQYF	singleton
CASSPPRTGGTNQPQHF	CASSPPRTGGTNQPQHF	singleton
CASSFGTVRPSGNTIYF	CASSFGTVRPSGNTIYF	singleton
CASSEYPGQGDLNYGYTF	CASSEYPGQGDLNYGYTF	singleton
CASKLREAGANVLTF	CASKLREAGANVLTF	singleton
CSARDWWSGYGYTF	CSARDWWSGYGYTF	singleton
CSASPATSYNEQFF	CSASPATSYNEQFF	singleton
CASSTSGGGEQYF	CASSTSGGGEQYF	singleton
CASSLAGGAWNEQYF	CASSLAGGAWNEQYF	singleton
CAAGTPGGNHGELFF	CAAGTPGGNHGELFF	singleton
CASSSTGGINYGYTF	CASSSTGGINYGYTF	singleton
CASTVSENSPLHF	CASTVSENSPLHF	singleton
CASSHQRQGADYGYTF	CASSHQRQGADYGYTF	singleton
CASSYTGTGNSPLHF	CASSYTGTGNSPLHF	singleton
CATTKQGTDTQYF	CATTKQGTDTQYF	singleton
CASSLVNGGNTEAFF	CASSLVNGGNTEAFF	singleton
CSARFSGGAGNEQFF	CSARFSGGAGNEQFF	singleton
CASSWDYQETQYF	CASSWDYQETQYF	singleton
CAWSIKGGVYEQYF	CAWSIKGGVYEQYF	singleton
CASSSSVRSFPLHF	CASSSSVRSFPLHF	singleton
CAWSVRPGTSKKPEQFF	CAWSVRPGTSKKPEQFF	singleton
CAWSVNSGNEQFF	CAWSVNSGNEQFF	singleton
CASRASGRVTEAFF	CASRASGRVTEAFF	singleton
CATSREQFPGELFF	CATSREQFPGELFF	singleton
CASSFSLGYPSYEQYF	CASSFSLGYPSYEQYF	singleton
CATQLGLQGYEQYF	CATQLGLQGYEQYF	singleton
CASSFAGFQETQYF	CASSFAGFQETQYF	singleton
CASSIWGQNSYEQYF	CASSIWGQNSYEQYF	singleton
CASSLGIPNGKLFF	CASSLGIPNGKLFF	singleton
CASSQGTSGSTDTQYF	CASSQGTSGSTDTQYF	singleton
CASTPGTLGGQFF	CASTPGTLGGQFF	singleton
CASSRDSSGGANVLTF	CASSRDSSGGANVLTF	singleton
CASSLNVPSNTGELFF	CASSLNVPSNTGELFF	singleton
CASSPLSGGANVLTF	CASSPLSGGANVLTF	singleton
CASTFLAVPTDTQYF	CASTFLAVPTDTQYF	singleton
CASSLAPNNGYTF	CASSLAPNNGYTF	singleton
CASSRREGPPGELFF	CASSRREGPPGELFF	singleton
CASSFTNVGDSPLHF	CASSFTNVGDSPLHF	singleton
CASSLGEGGKAFF	CASSLGEGGKAFF	singleton
CASSSRETQYF	CASSSRETQYF	singleton
CASSQGPGTSGTEQYF	CASSQGPGTSGTEQYF	singleton
CASSLVSGVGREQFF	CASSLVSGVGREQFF	singleton
CASRRVGETQYF	CASRRVGETQYF	singleton
CASSRIPVGTGGYNSPLHF	CASSRIPVGTGGYNSPLHF	singleton
CASRTGTPTYEQYF	CASRTGTPTYEQYF	singleton
CASMRAGEQFF	CASMRAGEQFF	singleton
CASSQGARISTNEKLFF	CASSQGARISTNEKLFF	singleton
CASSGYSEPATEAFF	CASSGYSEPATEAFF	singleton
CASRMTSGSFETQYF	CASRMTSGSFETQYF	singleton
CASSHGTSGTRYNEQFF	CASSHGTSGTRYNEQFF	singleton
CSAREWGIGYNSPLHF	CSAREWGIGYNSPLHF	singleton
CASSRRTSGKSYNEQFF	CASSRRTSGKSYNEQFF	singleton
CASRKQETQYF	CASRKQETQYF	singleton
CASSPEGQGAYNEQFF	CASSPEGQGAYNEQFF	singleton
CASTRTAIYEQYF	CASTRTAIYEQYF	singleton
CASSQATGRTEAFF	CASSQATGRTEAFF	singleton
CASRPPSGSWYEQYF	CASRPPSGSWYEQYF	singleton
CASITGGRRTEAFF	CASITGGRRTEAFF	singleton
CASSLSVPAFGNTIYF	CASSLSVPAFGNTIYF	singleton
CASSIGQGLDYTF	CASSIGQGLDYTF	singleton
CASSVTSGRGTGELFF	CASSVTSGRGTGELFF	singleton
CASSNRPGIGETQYF	CASSNRPGIGETQYF	singleton
CASSRGTGVAYGYTF	CASSRGTGVAYGYTF	singleton
CASSDFAGGLNEQFF	CASSDFAGGLNEQFF	singleton
CASSPSRRNEQFF	CASSPSRRNEQFF	singleton
CASSATGLVDEQFF	CASSATGLVDEQFF	singleton
CASSLSRVQAFF	CASSLSRVQAFF	singleton
CASSPDSYQGSPLHF	CASSPDSYQGSPLHF	singleton
CASSYSVLGNNYGYTF	CASSYSVLGNNYGYTF	singleton
CATVRDSSYEQYF	CATVRDSSYEQYF	singleton
CASSLAEGPGNTIYF	CASSLAEGPGNTIYF	singleton
CASSFRGKIEAFF	CASSFRGKIEAFF	singleton
CASSTYRQGGRGYTF	CASSTYRQGGRGYTF	singleton
CASRSGGQADTQYF	CASRSGGQADTQYF	singleton
CASSSGGYYGYTF	CASSSGGYYGYTF	singleton
CSASAGPEQFF	CSASAGPEQFF	singleton
CASSGGIAGGQGGELFF	CASSGGIAGGQGGELFF	singleton
CAARGTENEQYF	CAARGTENEQYF	singleton
CASSLNPTGFPYGYTF	CASSLNPTGFPYGYTF	singleton
CASRYLAGEGNEQFF	CASRYLAGEGNEQFF	singleton
CSAGQGALGLIGTDTQYF	CSAGQGALGLIGTDTQYF	singleton
CSARPTGTGNQPQHF	CSARPTGTGNQPQHF	singleton
CASIHAPGQGAEQYF	CASIHAPGQGAEQYF	singleton
CSVGSEYYEQYF	CSVGSEYYEQYF	singleton
CAIANQPGGNNSPLHF	CAIANQPGGNNSPLHF	singleton
CSARDTGFNNSPLHF	CSARDTGFNNSPLHF	singleton
CASSAAGEPYNEQFF	CASSAAGEPYNEQFF	singleton
CASSPSKWGGSLATNEKLFF	CASSPSKWGGSLATNEKLFF	singleton
CASSLDSGLRNTEAFF	CASSLDSGLRNTEAFF	singleton
CASSLTPGTSGRGNIQYF	CASSLTPGTSGRGNIQYF	singleton
CASSPKYRDSEYYGYTF	CASSPKYRDSEYYGYTF	singleton
CASSPTHRLAGNTEAFF	CASSPTHRLAGNTEAFF	singleton
CASSYDLASTGEQYF	CASSYDLASTGEQYF	singleton
CSADRAGGHNEQFF	CSADRAGGHNEQFF	singleton
CASSLTVSGGEQFF	CASSLTVSGGEQFF	singleton
CSVDRTGSDYGYTF	CSVDRTGSDYGYTF	singleton
CASSPSGGYTDTQYF	CASSPSGGYTDTQYF	singleton
CASLRWGGTF	CASLRWGGTF	singleton
CASSSTGGSGKTEAFF	CASSSTGGSGKTEAFF	singleton
CASSYVGLKKEQFF	CASSYVGLKKEQFF	singleton
CASSRGQLNTEAFF	CASSRGQLNTEAFF	singleton
CASAIAGGLADTQYF	CASAIAGGLADTQYF	singleton
CASSYLGGGSYGYTF	CASSYLGGGSYGYTF	singleton
CASSFTGGLTDTQYF	CASSFTGGLTDTQYF	singleton
CASSQGTSGTYEQYF	CASSQGTSGTYEQYF	singleton
CASSAWTSGKRGDTQYF	CASSAWTSGKRGDTQYF	singleton
CASSRSGGQGFQETQYF	CASSRSGGQGFQETQYF	singleton
CASSFLNSQPQHF	CASSFLNSQPQHF	singleton
CASCRDSSNQPQHF	CASCRDSSNQPQHF	singleton
CAWTSGGAYEQYF	CAWTSGGAYEQYF	singleton
CASSSGQGATNEKLFF	CASSSGQGATNEKLFF	singleton
CATSMGGRESEQFF	CATSMGGRESEQFF	singleton
CASSVGRSYEQYF	CASSVGRSYEQYF	singleton
CASSLAPGIHEQYF	CASSLAPGIHEQYF	singleton
CSAPRAAHKSTEAFF	CSAPRAAHKSTEAFF	singleton
CASTPGGMGDTQYF	CASTPGGMGDTQYF	singleton
CSVEDRGREAFF	CSVEDRGREAFF	singleton
CASSQSGTGSSKLFF	CASSQSGTGSSKLFF	singleton
CASSQGSGGGNEQFF	CASSQGSGGGNEQFF	singleton
CASRNHSSYEQYF	CASRNHSSYEQYF	singleton
CASSLALAHEQYF	CASSLALAHEQYF	singleton
CAWSTTGATYEQYF	CAWSTTGATYEQYF	singleton
CASSLLGAQSYEQYF	CASSLLGAQSYEQYF	singleton
CASSLGLAGGVTQYF	CASSLGLAGGVTQYF	singleton
CASSSQSAGAGEAFF	CASSSQSAGAGEAFF	singleton
CASSGTGSRALQFF	CASSGTGSRALQFF	singleton
CASSLFGTGGYGGYTF	CASSLFGTGGYGGYTF	singleton
CASSSGGAGGYGYTF	CASSSGGAGGYGYTF	singleton
CASTVVGHEQYF	CASTVVGHEQYF	singleton
CAISETSGSSANTGELFF	CAISETSGSSANTGELFF	singleton
CASVQGAYNEQFF	CASVQGAYNEQFF	singleton
CASSLGPGLNTDTQYF	CASSLGPGLNTDTQYF	singleton
CASSRGTGVQETQYF	CASSRGTGVQETQYF	singleton
CASSTGWTGGDTQYF	CASSTGWTGGDTQYF	singleton
CASSLGGPAYSNQPQHF	CASSLGGPAYSNQPQHF	singleton
CASSYSTSGGAYEQFF	CASSYSTSGGAYEQFF	singleton
CASSLTPGSSYGYTF	CASSLTPGSSYGYTF	singleton
CSANPSDYYNEQFF	CSANPSDYYNEQFF	singleton
CASSLRGGGSGANVLTF	CASSLRGGGSGANVLTF	singleton
CASSLGPSSNEQFF	CASSLGPSSNEQFF	singleton
CATTGGRHYGYTF	CATTGGRHYGYTF	singleton
CASSLFGVGGRYQPQHF	CASSLFGVGGRYQPQHF	singleton
CASRRPDMNTEAFF	CASRRPDMNTEAFF	singleton
CASSLVQGALGNTIYF	CASSLVQGALGNTIYF	singleton
CASSWTGAWDNEQFF	CASSWTGAWDNEQFF	singleton
CASAGQMNTEAFF	CASAGQMNTEAFF	singleton
CASSSDRGEGANVLTF	CASSSDRGEGANVLTF	singleton
CASSLDFGGTGGYEQYF	CASSLDFGGTGGYEQYF	singleton
CASSLPPSEAHF	CASSLPPSEAHF	singleton
CASSLRGTPDEQYF	CASSLRGTPDEQYF	singleton
CASSSRQGHTEAFF	CASSSRQGHTEAFF	singleton
CASTHGSGWETQYF	CASTHGSGWETQYF	singleton
CASSLSGWLAGGGSYNEQFF	CASSLSGWLAGGGSYNEQFF	singleton
CASSLGTGFFEQFF	CASSLGTGFFEQFF	singleton
CASQIPGGNQPQHF	CASQIPGGNQPQHF	singleton
CASSQGLAGDYNEQFF	CASSQGLAGDYNEQFF	singleton
CASSLQAGPTYGYTF	CASSLQAGPTYGYTF	singleton
CASSYSASGRYNEQFF	CASSYSASGRYNEQFF	singleton
CSARDAGQGNQPQHF	CSARDAGQGNQPQHF	singleton
CASSQPVGGWEQFF	CASSQPVGGWEQFF	singleton
CAISESDQPQHF	CAISESDQPQHF	singleton
CASSQGHGGSTDTQYF	CASSQGHGGSTDTQYF	singleton
CASSLGPILPYEQYF	CASSLGPILPYEQYF	singleton
CASTPRTRNNEQFF	CASTPRTRNNEQFF	singleton
CASSDTSGSWQETQYF	CASSDTSGSWQETQYF	singleton
CASSHRIAGELAKNIQYF	CASSHRIAGELAKNIQYF	singleton
CASSLTGTSRQETQYF	CASSLTGTSRQETQYF	singleton
CASSLRGQGNEKLFF	CASSLRGQGNEKLFF	singleton
CASRDSNRGMNTEAFF	CASRDSNRGMNTEAFF	singleton
CATRAESSYNSPLHF	CATRAESSYNSPLHF	singleton
CASSFDGGDQPQHF	CASSFDGGDQPQHF	singleton
CASSLEGRYLTDTQYF	CASSLEGRYLTDTQYF	singleton
CASSLGTPGFSTDTQYF	CASSLGTPGFSTDTQYF	singleton
CASSQGRTNEKLFF	CASSQGRTNEKLFF	singleton
CASSPRQGGEQYF	CASSPRQGGEQYF	singleton
CASSHTGLGSNEQFF	CASSHTGLGSNEQFF	singleton
CAWTLVNAYNEQFF	CAWTLVNAYNEQFF	singleton
CSASWDSGDEKLFF	CSASWDSGDEKLFF	singleton
CASRLGSGREGTQYF	CASRLGSGREGTQYF	singleton
CAISDSGTGTDTQYF	CAISDSGTGTDTQYF	singleton
CASGRKAYNSPLHF	CASGRKAYNSPLHF	singleton
CATSPRGAGPQHF	CATSPRGAGPQHF	singleton
CASSQVWDRGYGYTF	CASSQVWDRGYGYTF	singleton
CASSVGRQADQPQHF	CASSVGRQADQPQHF	singleton
CASSAQGTGGYEQYF	CASSAQGTGGYEQYF	singleton
CSARVTSNTDTQYF	CSARVTSNTDTQYF	singleton
CASSASPNHEQFF	CASSASPNHEQFF	singleton
CASSGRTGENSPLHF	CASSGRTGENSPLHF	singleton
CASSQLGTGSYNEQFF	CASSQLGTGSYNEQFF	singleton
CASSEALRGGTDTQYF	CASSEALRGGTDTQYF	singleton
CASSVADFQSSVSANTGELFF	CASSVADFQSSVSANTGELFF	singleton
CASTLAGGRLFF	CASTLAGGRLFF	singleton
CASSGPSAGGPTGELFF	CASSGPSAGGPTGELFF	singleton
CASSRLGAAPNQPQHF	CASSRLGAAPNQPQHF	singleton
CASSPAGGLTLPYEQYF	CASSPAGGLTLPYEQYF	singleton
CAWSVGEYGYTF	CAWSVGEYGYTF	singleton
CASSLGSLYGYTF	CASSLGSLYGYTF	singleton
CASSPQGADTQYF	CASSPQGADTQYF	singleton
CASTGPNTEAFF	CASTGPNTEAFF	singleton
CASTKGGKWATDTQYF	CASTKGGKWATDTQYF	singleton
CASSVTGVGGNTIYF	CASSVTGVGGNTIYF	singleton
CASSLGGQGHYNEQFF	CASSLGGQGHYNEQFF	singleton
CASSLSERNYNEQFF	CASSLSERNYNEQFF	singleton
CASSPQGFYEQYF	CASSPQGFYEQYF	singleton
CASSQLVLGTAYEQYF	CASSQLVLGTAYEQYF	singleton
CASSLLPGQTGANVLTF	CASSLLPGQTGANVLTF	singleton
CATISPGKTNSPLHF	CATISPGKTNSPLHF	singleton
CASSPPTGTSEQYF	CASSPPTGTSEQYF	singleton
CASSVDRGLNSPLHF	CASSVDRGLNSPLHF	singleton
CASSLDPRREGEQFF	CASSLDPRREGEQFF	singleton
CASSEANHRIRNSPLHF	CASSEANHRIRNSPLHF	singleton
CASSYSGRVAFF	CASSYSGRVAFF	singleton
CASSIDAFNQPQHF	CASSIDAFNQPQHF	singleton
CASRESGTQNYEQYF	CASRESGTQNYEQYF	singleton
CASSYGRAPGETQYF	CASSYGRAPGETQYF	singleton
CSASGRAPGQFF	CSASGRAPGQFF	singleton
CASSEVGQGAYGYTF	CASSEVGQGAYGYTF	singleton
CSALQLRETQYF	CSALQLRETQYF	singleton
CSARRESGQIYNEQFF	CSARRESGQIYNEQFF	singleton
CAWSTGPGNTIYF	CAWSTGPGNTIYF	singleton
CASSLVGRGRNYNEQFF	CASSLVGRGRNYNEQFF	singleton
CASSLATGGNPGNTIYF	CASSLATGGNPGNTIYF	singleton
CASRNSDYGYTF	CASRNSDYGYTF	singleton
CAWSSLRTAPYEQYF	CAWSSLRTAPYEQYF	singleton
CASSLAGTGTTFF	CASSLAGTGTTFF	singleton
CASSRGYESNQPQHF	CASSRGYESNQPQHF	singleton
CASNFRRDTEAFF	CASNFRRDTEAFF	singleton
CSVGAEFSTDTQYF	CSVGAEFSTDTQYF	singleton
CSAREGLAEQYF	CSAREGLAEQYF	singleton
CASGLQNTEAFF	CASGLQNTEAFF	singleton
CASSYSAGPITDTQYF	CASSYSAGPITDTQYF	singleton
CASSSPGQSYNEQFF	CASSSPGQSYNEQFF	singleton
CASSPSAASYEQFF	CASSPSAASYEQFF	singleton
CASSSRQGLTGELFF	CASSSRQGLTGELFF	singleton
CASSEWGKGVGTDTQYF	CASSEWGKGVGTDTQYF	singleton
CSARDLRAEAFF	CSARDLRAEAFF	singleton
CAISLRDRGTDTQYF	CAISLRDRGTDTQYF	singleton
CANPSRGGYTF	CANPSRGGYTF	singleton
CSAGNYEQYF	CSAGNYEQYF	singleton
CASSEIRGQETQYF	CASSEIRGQETQYF	singleton
CSARPGLAVYEQYF	CSARPGLAVYEQYF	singleton
CASSLADREEQYF	CASSLADREEQYF	singleton
CSVNNRGRSSPLHF	CSVNNRGRSSPLHF	singleton
CASSWGAGRGYTF	CASSWGAGRGYTF	singleton
CASSLPGQAEKLFF	CASSLPGQAEKLFF	singleton
CASSVEGGNQPQHF	CASSVEGGNQPQHF	singleton
CASSPRSTGQPQHF	CASSPRSTGQPQHF	singleton
CASSQGPLAGDRTDTQYF	CASSQGPLAGDRTDTQYF	singleton
CASSLPGLNQPQHF	CASSLPGLNQPQHF	singleton
CASSEQGLGEQYF	CASSEQGLGEQYF	singleton
CASSWRTSGGTGELFF	CASSWRTSGGTGELFF	singleton
CASSFLGGGAEKLFF	CASSFLGGGAEKLFF	singleton
CASSLTGVPYEQYF	CASSLTGVPYEQYF	singleton
CASGRGGTDTQYF	CASGRGGTDTQYF	singleton
CAWSARGNTGELFF	CAWSARGNTGELFF	singleton
CSVTDANTQYF	CSVTDANTQYF	singleton
CASSYSAVGVESYEQYF	CASSYSAVGVESYEQYF	singleton
CASSTHRGANSPLHF	CASSTHRGANSPLHF	singleton
CASSWGSSNQPQHF	CASSWGSSNQPQHF	singleton
CASSPISQETQYF	CASSPISQETQYF	singleton
CASSLEVGGPQYF	CASSLEVGGPQYF	singleton
CASSQDRGRVNTEAFF	CASSQDRGRVNTEAFF	singleton
CASSPSGWQETQYF	CASSPSGWQETQYF	singleton
CATSAAAGVRNQPQHF	CATSAAAGVRNQPQHF	singleton
CSARPRADTEAFF	CSARPRADTEAFF	singleton
CASSPETTGSNEQFF	CASSPETTGSNEQFF	singleton
CASDPSGKNTGELFF	CASDPSGKNTGELFF	singleton
CSVYRVGGYTF	CSVYRVGGYTF	singleton
CALNRRQPRYYGYTF	CALNRRQPRYYGYTF	singleton
CASSSGLANEQFF	CASSSGLANEQFF	singleton
CSARLRVNNSPLHF	CSARLRVNNSPLHF	singleton
CASSPGVGTQYF	CASSPGVGTQYF	singleton
CASSSPHLSSYEQYF	CASSSPHLSSYEQYF	singleton
CASSYGTGEGFKNIQYF	CASSYGTGEGFKNIQYF	singleton
CASSVREGGTEAFF	CASSVREGGTEAFF	singleton
CASSLESATNEKLFF	CASSLESATNEKLFF	singleton
CASSQDYGTIIYF	CASSQDYGTIIYF	singleton
CSAAGTAYEQYF	CSAAGTAYEQYF	singleton
CAWSVPPLGNTIYF	CAWSVPPLGNTIYF	singleton
CASSLYPRETQYF	CASSLYPRETQYF	singleton
CASSDGTILTGELFF	CASSDGTILTGELFF	singleton
CATSGGGGDYNEQFF	CATSGGGGDYNEQFF	singleton
CASSYVPVLAYEQYF	CASSYVPVLAYEQYF	singleton
CSVGETSEQYF	CSVGETSEQYF	singleton
CASSIFQGSNQPQHF	CASSIFQGSNQPQHF	singleton
CASSPGTRLTGELFF	CASSPGTRLTGELFF	singleton
CSASGQGYDQPQHF	CSASGQGYDQPQHF	singleton
CATSDSSGENTGELFF	CATSDSSGENTGELFF	singleton
CATSDPDRFNEQFF	CATSDPDRFNEQFF	singleton
CAISESSRGQGGYTF	CAISESSRGQGGYTF	singleton
CASSDAAGAETQYF	CASSDAAGAETQYF	singleton
CASSPLSEQYF	CASSPLSEQYF	singleton
CASSGATGTRPYNEQFF	CASSGATGTRPYNEQFF	singleton
CASSHLAGTDTQYF	CASSHLAGTDTQYF	singleton
CASSQGTEAFF	CASSQGTEAFF	singleton
CATSDGDGSTETQYF	CATSDGDGSTETQYF	singleton
CASSIAASNYEQYF	CASSIAASNYEQYF	singleton
CASSQATSGGPNEQFF	CASSQATSGGPNEQFF	singleton
CASSPTQGTEYEQYF	CASSPTQGTEYEQYF	singleton
CSAQSGITDTQYF	CSAQSGITDTQYF	singleton
CASSIKAINEQFF	CASSIKAINEQFF	singleton
CASSNMNTEAFF	CASSNMNTEAFF	singleton
CASSSGDVNTEAFF	CASSSGDVNTEAFF	singleton
CASSRLTLAGGPPSSYNEQFF	CASSRLTLAGGPPSSYNEQFF	singleton
CASSQYPETNYGYTF	CASSQYPETNYGYTF	singleton
CASSPGGDNSPLHF	CASSPGGDNSPLHF	singleton
CASSVPAGGLYLPDTQYF	CASSVPAGGLYLPDTQYF	singleton
CASSSRTDEQFF	CASSSRTDEQFF	singleton
CASSFPAGGASNYGYTF	CASSFPAGGASNYGYTF	singleton
CASSYSMETQYF	CASSYSMETQYF	singleton
CASSPGPGSSYNEQFF	CASSPGPGSSYNEQFF	singleton
CASSFGTGESNQPQHF	CASSFGTGESNQPQHF	singleton
CSVVAQGLAGWATDTQYF	CSVVAQGLAGWATDTQYF	singleton
CASSFRPGFNQPQHF	CASSFRPGFNQPQHF	singleton
CASSEGTGYQPQHF	CASSEGTGYQPQHF	singleton
CASGPGPRRDTQYF	CASGPGPRRDTQYF	singleton
CASSPGSGEGYGYTF	CASSPGSGEGYGYTF	singleton
CASRTGTLQGISPLHF	CASRTGTLQGISPLHF	singleton
CASKAGGPTGTDTQYF	CASKAGGPTGTDTQYF	singleton
CASSPETGTEAFF	CASSPETGTEAFF	singleton
CASSLVAPTGVDEKLFF	CASSLVAPTGVDEKLFF	singleton
CASSLGPAPWAQHF	CASSLGPAPWAQHF	singleton
CASSISLQGTDTQYF	CASSISLQGTDTQYF	singleton
CAWSQGVGNTIYF	CAWSQGVGNTIYF	singleton
CASSWGQRLNEQFF	CASSWGQRLNEQFF	singleton
CASSPRRILQETQYF	CASSPRRILQETQYF	singleton
CASSYPDRGGAEAFF	CASSYPDRGGAEAFF	singleton
CASSQSGGGGYTF	CASSQSGGGGYTF	singleton
CASSLEQIYEQYF	CASSLEQIYEQYF	singleton
CAWSMDSHNEQFF	CAWSMDSHNEQFF	singleton
CATSAKRDWTTEQFF	CATSAKRDWTTEQFF	singleton
CSARGSYGYTF	CSARGSYGYTF	singleton
CSARSGRVNTGELFF	CSARSGRVNTGELFF	singleton
CASSEGLSNSPLHF	CASSEGLSNSPLHF	singleton
CASSQAGRLGYNEQFF	CASSQAGRLGYNEQFF	singleton
CASSPGLAGFTDTQYF	CASSPGLAGFTDTQYF	singleton
CASSSRDSSYEQYF	CASSSRDSSYEQYF	singleton
CSGDASGSFNEQFF	CSGDASGSFNEQFF	singleton
CATSEVGGSTTNTGELFF	CATSEVGGSTTNTGELFF	singleton
CASSIGLGERSLYNEQFF	CASSIGLGERSLYNEQFF	singleton
CASSELASRSVEQFF	CASSELASRSVEQFF	singleton
CASTLGRTNTGELFF	CASTLGRTNTGELFF	singleton
CATSDGTVGTEAFF	CATSDGTVGTEAFF	singleton
CASSTSGAPGNTIYF	CASSTSGAPGNTIYF	singleton
CSVTGGTDTQYF	CSVTGGTDTQYF	singleton
CASSFSGGASNEQFF	CASSFSGGASNEQFF	singleton
CASSLRDTRPGELFF	CASSLRDTRPGELFF	singleton
CASSVGGGYGYTF	CASSVGGGYGYTF	singleton
CASSNDRDGGSEKLFF	CASSNDRDGGSEKLFF	singleton
CASSPNMGTGRNQPQHF	CASSPNMGTGRNQPQHF	singleton
CASSQSSFGQGTGELFF	CASSQSSFGQGTGELFF	singleton
CASSSQGDNEQFF	CASSSQGDNEQFF	singleton
CASKELGGPSSYEQYF	CASKELGGPSSYEQYF	singleton
CASTKNTGSNEKLFF	CASTKNTGSNEKLFF	singleton
CASSFGGTDQPQHF	CASSFGGTDQPQHF	singleton
CARSTSGVTDTQYF	CARSTSGVTDTQYF	singleton
CASTAGGGGRTDTQYF	CASTAGGGGRTDTQYF	singleton
CASSLALTSGGSYNEQFF	CASSLALTSGGSYNEQFF	singleton
CSASGPGSYNEQFF	CSASGPGSYNEQFF	singleton
CASSLRTSGTGELFF	CASSLRTSGTGELFF	singleton
CASSLKAGGLEQYF	CASSLKAGGLEQYF	singleton
CAIRPDRPMNTEAFF	CAIRPDRPMNTEAFF	singleton
CASSFAAGVADTQYF	CASSFAAGVADTQYF	singleton
CASSLHREVNEQFF	CASSLHREVNEQFF	singleton
CASSYRVGVSPNTEAFF	CASSYRVGVSPNTEAFF	singleton
CASSEGAYQETQYF	CASSEGAYQETQYF	singleton
CSARGAGGNGYHGYTF	CSARGAGGNGYHGYTF	singleton
CASSLEAGQGGSEKLFF	CASSLEAGQGGSEKLFF	singleton
CASSTFLGRGNEQFF	CASSTFLGRGNEQFF	singleton
CSAAHGTEGQYF	CSAAHGTEGQYF	singleton
CASSPSGVAYEQYF	CASSPSGVAYEQYF	singleton
CASTRPDYYEQYF	CASTRPDYYEQYF	singleton
CASSSTGPAYEQYF	CASSSTGPAYEQYF	singleton
CASSQARGRVGYTF	CASSQARGRVGYTF	singleton
CASRRPSGGDTQYF	CASRRPSGGDTQYF	singleton
CASSQGPVETQYF	CASSQGPVETQYF	singleton
CASSFKLAGGGQETQYF	CASSFKLAGGGQETQYF	singleton
CASSYLGLTEAFF	CASSYLGLTEAFF	singleton
CASSSSPGQGASEQFF	CASSSSPGQGASEQFF	singleton
CASSAQGTSNQPQHF	CASSAQGTSNQPQHF	singleton
CASKTVDGQGGNSPLHF	CASKTVDGQGGNSPLHF	singleton
CATSDWTGGDGYTF	CATSDWTGGDGYTF	singleton
CASSQEGRFSGNTIYF	CASSQEGRFSGNTIYF	singleton
CATSDRSGGLSTDTQYF	CATSDRSGGLSTDTQYF	singleton
CASSQVRRDEKLFF	CASSQVRRDEKLFF	singleton
CASSLVSADEKLFF	CASSLVSADEKLFF	singleton
CASSLSGRTYSGNTIYF	CASSLSGRTYSGNTIYF	singleton
CASSTGFSRIAKNIQYF	CASSTGFSRIAKNIQYF	singleton
CASARPSALSYEQYF	CASARPSALSYEQYF	singleton
CASSPQSESPQHF	CASSPQSESPQHF	singleton
CASSIDRVSGANVLTF	CASSIDRVSGANVLTF	singleton
CAWSPPSTTGNYGYTF	CAWSPPSTTGNYGYTF	singleton
CASSGEENTEAFF	CASSGEENTEAFF	singleton
CASSLRVSYEQYF	CASSLRVSYEQYF	singleton
CASSPPTAQETQYF	CASSPPTAQETQYF	singleton
CASSPTAGTNTGELFF	CASSPTAGTNTGELFF	singleton
CASSLGQGVAYEQYF	CASSLGQGVAYEQYF	singleton
CASSWGRGYTF	CASSWGRGYTF	singleton
CASSTGPQQSTGELFF	CASSTGPQQSTGELFF	singleton
CASSLAQGHYEQYF	CASSLAQGHYEQYF	singleton
CASSHGREYDYGYTF	CASSHGREYDYGYTF	singleton
CASSLGRAQETQYF	CASSLGRAQETQYF	singleton
CASSWEAGNLRYEQYF	CASSWEAGNLRYEQYF	singleton
CASNPGLLSYEQYF	CASNPGLLSYEQYF	singleton
CASSITGYEQYF	CASSITGYEQYF	singleton
CASSLAGGYGSYNEQFF	CASSLAGGYGSYNEQFF	singleton
CASSQDGGTSSTDTQYF	CASSQDGGTSSTDTQYF	singleton
CASSPEGSGGPKSTDTQYF	CASSPEGSGGPKSTDTQYF	singleton
CATFRRGTSGRASDTQYF	CATFRRGTSGRASDTQYF	singleton
CASPPDVGRISYEQYF	CASPPDVGRISYEQYF	singleton
CASSRMGTSGRGSQETQYF	CASSRMGTSGRGSQETQYF	singleton
CASSLELETAPKRYEQYF	CASSLELETAPKRYEQYF	singleton
CASAIKQGYNSPLHF	CASAIKQGYNSPLHF	singleton
CASSEQGGVGAFF	CASSEQGGVGAFF	singleton
CASSLFGSEMNTEAFF	CASSLFGSEMNTEAFF	singleton
CSGLALDYEQYF	CSGLALDYEQYF	singleton
CASSFLAGDQETQYF	CASSFLAGDQETQYF	singleton
CASSPTRGRAQYF	CASSPTRGRAQYF	singleton
CAISEWAGSSYNEQFF	CAISEWAGSSYNEQFF	singleton
CASSLSEYNSPLHF	CASSLSEYNSPLHF	singleton
CASRTGISTDTQYF	CASRTGISTDTQYF	singleton
CSARDTLQGLVSYEQYF	CSARDTLQGLVSYEQYF	singleton
CASRGGIASPYEQYF	CASRGGIASPYEQYF	singleton
CASSRTSGGRTGELFF	CASSRTSGGRTGELFF	singleton
CASRPSYSGAGDTQYF	CASRPSYSGAGDTQYF	singleton
CASSLGLAGGPSSYNEQFF	CASSLGLAGGPSSYNEQFF	singleton
CASSDFQQPQHF	CASSDFQQPQHF	singleton
CASSQTATGELFF	CASSQTATGELFF	singleton
CASNRQGYGYTF	CASNRQGYGYTF	singleton
CASSESAGAGELFF	CASSESAGAGELFF	singleton
CASTVLRTSGGNEQYF	CASTVLRTSGGNEQYF	singleton
CSVRDEVRASYGYTF	CSVRDEVRASYGYTF	singleton
CASSLVDRRNEQYF	CASSLVDRRNEQYF	singleton
CAWSPKYEQYF	CAWSPKYEQYF	singleton
CSARDSWREVSSYNEQFF	CSARDSWREVSSYNEQFF	singleton
CATSRGGAKNIQYF	CATSRGGAKNIQYF	singleton
CASNRGLASYEQYF	CASNRGLASYEQYF	singleton
CASSLDDTAGYLENEQFF	CASSLDDTAGYLENEQFF	singleton
CASSLGTSGMGNEQFF	CASSLGTSGMGNEQFF	singleton
CASSPGRGGGNEQFF	CASSPGRGGGNEQFF	singleton
CASSHRGGTNEKLFF	CASSHRGGTNEKLFF	singleton
CASSFPSGRATNTGELFF	CASSFPSGRATNTGELFF	singleton
CASSAGLSQPQHF	CASSAGLSQPQHF	singleton
CASSRQGFISF	CASSRQGFISF	singleton
CASSLRDGQNQPQHF	CASSLRDGQNQPQHF	singleton
CASSFGGAADTQYF	CASSFGGAADTQYF	singleton
CASSPPLGAGKNIQYF	CASSPPLGAGKNIQYF	singleton
CASSIFLTGTGYTF	CASSIFLTGTGYTF	singleton
CASSTGLGVETQYF	CASSTGLGVETQYF	singleton
CASSRQGLGAEAFF	CASSRQGLGAEAFF	singleton
CASSAGQGASWETQYF	CASSAGQGASWETQYF	singleton
CASSPPGNDQPQHF	CASSPPGNDQPQHF	singleton
CAWSYRGGKAFF	CAWSYRGGKAFF	singleton
CASSPPPSGGGPYNEQFF	CASSPPPSGGGPYNEQFF	singleton
CATSRDFNAGLQSRPQHF	CATSRDFNAGLQSRPQHF	singleton
CASTRGGYQETQYF	CASTRGGYQETQYF	singleton
CAWSVSAEAFF	CAWSVSAEAFF	singleton
CASSQDHSTGNSNQPQHF	CASSQDHSTGNSNQPQHF	singleton
CASSLEIGLAGGDEQFF	CASSLEIGLAGGDEQFF	singleton
CSAPPGTRDFYEQYF	CSAPPGTRDFYEQYF	singleton
CASSSQGPGYGYTF	CASSSQGPGYGYTF	singleton
CASSTRSTDTQYF	CASSTRSTDTQYF	singleton
CASSRAGTGTYNEQFF	CASSRAGTGTYNEQFF	singleton
CSARDLLTVYEQYF	CSARDLLTVYEQYF	singleton
CATSRALVTEAFF	CATSRALVTEAFF	singleton
CASSVTDLFEQFF	CASSVTDLFEQFF	singleton
CASSLAGNRAHGYTF	CASSLAGNRAHGYTF	singleton
CASSVGLASTDTQYF	CASSVGLASTDTQYF	singleton
CSARKQGRYEQYF	CSARKQGRYEQYF	singleton
CATQQGASGANVLTF	CATQQGASGANVLTF	singleton
CASSPAGPGSGGYTF	CASSPAGPGSGGYTF	singleton
CASSMGTSVSWEQYF	CASSMGTSVSWEQYF	singleton
CAISSQAGAINEQFF	CAISSQAGAINEQFF	singleton
CASSSIRDRRSTEAFF	CASSSIRDRRSTEAFF	singleton
CASSLGLQGGGYEQYF	CASSLGLQGGGYEQYF	singleton
CASTEGRTDTQYF	CASTEGRTDTQYF	singleton
CASADLDIQYF	CASADLDIQYF	singleton
CASTRGSAGDTQYF	CASTRGSAGDTQYF	singleton
CASSQLAGKVVETQYF	CASSQLAGKVVETQYF	singleton
CASSLELAGGSEQFF	CASSLELAGGSEQFF	singleton
CASSYFRPETGRNTGELFF	CASSYFRPETGRNTGELFF	singleton
CASSLRTGDTEAFF	CASSLRTGDTEAFF	singleton
CSTPSQGNYGYTF	CSTPSQGNYGYTF	singleton
CATSVVAGVSLNRETQYF	CATSVVAGVSLNRETQYF	singleton
CASSLTSTRSRASEQFF	CASSLTSTRSRASEQFF	singleton
CASSPSPGQGSSNNSPLHF	CASSPSPGQGSSNNSPLHF	singleton
CASSSPTGGNEKLFF	CASSSPTGGNEKLFF	singleton
CASTPRVGATYEQYF	CASTPRVGATYEQYF	singleton
CASSQDLRLAGAEQFF	CASSQDLRLAGAEQFF	singleton
CSAPSPQGAGGELFF	CSAPSPQGAGGELFF	singleton
CASSAQGAFGDTQYF	CASSAQGAFGDTQYF	singleton
CASSHLTGNTGELFF	CASSHLTGNTGELFF	singleton
CASSSPGENTGELFF	CASSSPGENTGELFF	singleton
CSVKEGTGPYEQYF	CSVKEGTGPYEQYF	singleton
CSARGGTHEGPQHF	CSARGGTHEGPQHF	singleton
CSASIHLAGELFF	CSASIHLAGELFF	singleton
CASNSGSGTDTQYF	CASNSGSGTDTQYF	singleton
CASSITGPPMDTQYF	CASSITGPPMDTQYF	singleton
CASSQVLAREKGREKLFF	CASSQVLAREKGREKLFF	singleton
CASSLDLGVRNYGYTF	CASSLDLGVRNYGYTF	singleton
CASSSRTDWNTEAFF	CASSSRTDWNTEAFF	singleton
CASSPASGTDTQYF	CASSPASGTDTQYF	singleton
CASRPGQGSYEQYF	CASRPGQGSYEQYF	singleton
CASSPEVGNSNQPQHF	CASSPEVGNSNQPQHF	singleton
CASSLSGRVTGELFF	CASSLSGRVTGELFF	singleton
CASSLKGNGETQYF	CASSLKGNGETQYF	singleton
CSVETNTNTGELFF	CSVETNTNTGELFF	singleton
CASRQRGSPLHF	CASRQRGSPLHF	singleton
CASSGSDTQYF	CASSGSDTQYF	singleton
CASSRNRDTPYEQYF	CASSRNRDTPYEQYF	singleton
CASSYDRGVGEAFF	CASSYDRGVGEAFF	singleton
CASSLRTGVSGYTF	CASSLRTGVSGYTF	singleton
CASSLGRAGYGYTF	CASSLGRAGYGYTF	singleton
CASSAYKGEETQYF	CASSAYKGEETQYF	singleton
CASSPKDSGHYEQYF	CASSPKDSGHYEQYF	singleton
CASSFTGGWDNEQFF	CASSFTGGWDNEQFF	singleton
CASSATRGRKNTEQYF	CASSATRGRKNTEQYF	singleton
CASSISQGSTGERF	CASSISQGSTGERF	singleton
CASSKAGTSGSTTQYF	CASSKAGTSGSTTQYF	singleton
CASSRRGWDEQFF	CASSRRGWDEQFF	singleton
CASSPGGETQYF	CASSPGGETQYF	singleton
CASSRTRDSYNEQFF	CASSRTRDSYNEQFF	singleton
CASSYSTGELFF	CASSYSTGELFF	singleton
CASSPPANTGELFF	CASSPPANTGELFF	singleton
CASSSGLGSNQPQHF	CASSSGLGSNQPQHF	singleton
CASIVEKGAGGYGYTF	CASIVEKGAGGYGYTF	singleton
CASKLSQGLSSPLHF	CASKLSQGLSSPLHF	singleton
CASTYERHGEYGYTF	CASTYERHGEYGYTF	singleton
CASSPPSYSPLHF	CASSPPSYSPLHF	singleton
CASSSTGTTEAFF	CASSSTGTTEAFF	singleton
CASRALAGDYKNIQYF	CASRALAGDYKNIQYF	singleton
CASSINRYSNQPQHF	CASSINRYSNQPQHF	singleton
CASRGGGRGAGELFF	CASRGGGRGAGELFF	singleton
CASSYWSENIQYF	CASSYWSENIQYF	singleton
CASSVGGGRDEQYF	CASSVGGGRDEQYF	singleton
CASSLTGTSTYEQYF	CASSLTGTSTYEQYF	singleton
CATQIRRQPQHF	CATQIRRQPQHF	singleton
CASSGQSGADTQYF	CASSGQSGADTQYF	singleton
CASSQATWAGGAGTDTQYF	CASSQATWAGGAGTDTQYF	singleton
CASSPSRRHGGAYEQYF	CASSPSRRHGGAYEQYF	singleton
CASSLRAGGQETQYF	CASSLRAGGQETQYF	singleton
CASSTGQSNEKLFF	CASSTGQSNEKLFF	singleton
CAWSVGGHSTDTQYF	CAWSVGGHSTDTQYF	singleton
CASSLISGEKLFF	CASSLISGEKLFF	singleton
CASRTSRGSTGELFF	CASRTSRGSTGELFF	singleton
CASSEGSTSLNTDTQYF	CASSEGSTSLNTDTQYF	singleton
CASSYSGTGAGELFF	CASSYSGTGAGELFF	singleton
CASSLTSGENNEQFF	CASSLTSGENNEQFF	singleton
CASRNRGLAVNEQFF	CASRNRGLAVNEQFF	singleton
CASSPLPGSEQFF	CASSPLPGSEQFF	singleton
CASSLAGTSGIGKAQYF	CASSLAGTSGIGKAQYF	singleton
CASRRGQGPYNEQFF	CASRRGQGPYNEQFF	singleton
CASSSSPGGYTF	CASSSSPGGYTF	singleton
CASSQTYNEQFF	CASSQTYNEQFF	singleton
CASSLASDTEAFF	CASSLASDTEAFF	singleton
CSARDSRGWGAGYEQYF	CSARDSRGWGAGYEQYF	singleton
CASSYFGSDEAFF	CASSYFGSDEAFF	singleton
CASSPGGYQNTEAFF	CASSPGGYQNTEAFF	singleton
CASSSMGKLFF	CASSSMGKLFF	singleton
CASSLNWQNYGYTF	CASSLNWQNYGYTF	singleton
CAISESLGRGLGDEQFF	CAISESLGRGLGDEQFF	singleton
CASSSSPSGGGDTQYF	CASSSSPSGGGDTQYF	singleton
CASIPGPMNTEAFF	CASIPGPMNTEAFF	singleton
CASSLDSSSSGELFF	CASSLDSSSSGELFF	singleton
CSDRSGSGEAFF	CSDRSGSGEAFF	singleton
CASSVRAGLAPDTQYF	CASSVRAGLAPDTQYF	singleton
CASSQNRLMNTGELFF	CASSQNRLMNTGELFF	singleton
CASSYSRNEQFF	CASSYSRNEQFF	singleton
CASSEARKAFF	CASSEARKAFF	singleton
CATSRDRGGHTNTQYF	CATSRDRGGHTNTQYF	singleton
CASSLMGGPNTEAFF	CASSLMGGPNTEAFF	singleton
CATEEAVLYGYTF	CATEEAVLYGYTF	singleton
CASSPLPSGANVLTF	CASSPLPSGANVLTF	singleton
CASSRARGEKLFF	CASSRARGEKLFF	singleton
CASSFPGLAANNEQFF	CASSFPGLAANNEQFF	singleton
CASSFGGWSNQPQHF	CASSFGGWSNQPQHF	singleton
CATSPTLSGLAFNEQFF	CATSPTLSGLAFNEQFF	singleton
CASSYVGGGNTGELFF	CASSYVGGGNTGELFF	singleton
CASNSGATEAFF	CASNSGATEAFF	singleton
CASSDRASSSYEQYF	CASSDRASSSYEQYF	singleton
CASSNPAGLQETQYF	CASSNPAGLQETQYF	singleton
CASRWAGNSGANVLTF	CASRWAGNSGANVLTF	singleton
CASSLKQGAYEQYF	CASSLKQGAYEQYF	singleton
CASSVVVGGSYEQYF	CASSVVVGGSYEQYF	singleton
CSARKGQGGNQPQHF	CSARKGQGGNQPQHF	singleton
CASSSVSQGFQPQHF	CASSSVSQGFQPQHF	singleton
CASSQALASGGVGEQFF	CASSQALASGGVGEQFF	singleton
CASSLGLDNEQFF	CASSLGLDNEQFF	singleton
CASSEDRVYGYTF	CASSEDRVYGYTF	singleton
CASSEYFPPYEQYF	CASSEYFPPYEQYF	singleton
CASSQDRSHSYEQYF	CASSQDRSHSYEQYF	singleton
CASSSSFSGRGEDEQFF	CASSSSFSGRGEDEQFF	singleton
CASSRWRVSSYNEQFF	CASSRWRVSSYNEQFF	singleton
CASSPGQGPHEQYF	CASSPGQGPHEQYF	singleton
CASSIFGGNTEAFF	CASSIFGGNTEAFF	singleton
CASRRTSGAGSYEQYF	CASRRTSGAGSYEQYF	singleton
CSVIGTGNQPQHF	CSVIGTGNQPQHF	singleton
CASSGGLAQETQYF	CASSGGLAQETQYF	singleton
CASSVGWGDGNTIYF	CASSVGWGDGNTIYF	singleton
CASSLSGLGADTQYF	CASSLSGLGADTQYF	singleton
CSAKAGEGTDTQYF	CSAKAGEGTDTQYF	singleton
CAISEVKRDTQYF	CAISEVKRDTQYF	singleton
CASSLASGSLETQYF	CASSLASGSLETQYF	singleton
CASSLNGYGIPNEQFF	CASSLNGYGIPNEQFF	singleton
CASSGGEVIGELFF	CASSGGEVIGELFF	singleton
CASRAGTSDFYTQYF	CASRAGTSDFYTQYF	singleton
CASTQGTGGAPYGYTF	CASTQGTGGAPYGYTF	singleton
CASSTLRGPNYGYTF	CASSTLRGPNYGYTF	singleton
CASSQDAGAVYEQYF	CASSQDAGAVYEQYF	singleton
CAWSVLSDQPQHF	CAWSVLSDQPQHF	singleton
CASSYNIQGSYNSPLHF	CASSYNIQGSYNSPLHF	singleton
CASSQGGGTYNEQFF	CASSQGGGTYNEQFF	singleton
CASSRIGTRNTGELFF	CASSRIGTRNTGELFF	singleton
CASSPGGNQETQYF	CASSPGGNQETQYF	singleton
CASSSSIAGLRGEQYF	CASSSSIAGLRGEQYF	singleton
CASSIDTTVNYGYTF	CASSIDTTVNYGYTF	singleton
CASSPSRGDQPQHF	CASSPSRGDQPQHF	singleton
CASSSGTHRGAFF	CASSSGTHRGAFF	singleton
CAWSVSRESSPLHF	CAWSVSRESSPLHF	singleton
CASSPDRAGTGELFF	CASSPDRAGTGELFF	singleton
CASSPGSSYEQYF	CASSPGSSYEQYF	singleton
CASRGGLGEAETQYF	CASRGGLGEAETQYF	singleton
CASSQDGQGDQPQHF	CASSQDGQGDQPQHF	singleton
CASSGRELIFNEQYF	CASSGRELIFNEQYF	singleton
CASSLEAGSADTQYF	CASSLEAGSADTQYF	singleton
CASSLLRDRGTGELFF	CASSLLRDRGTGELFF	singleton
CASSLEIQSASGNTIYF	CASSLEIQSASGNTIYF	singleton
CATSPSGVNNEQFF	CATSPSGVNNEQFF	singleton
CSARTQGPYEQYF	CSARTQGPYEQYF	singleton
CASSGAGTSGSYEQYF	CASSGAGTSGSYEQYF	singleton
CAPQWGANEKLFF	CAPQWGANEKLFF	singleton
CASSIVSGTTEAFF	CASSIVSGTTEAFF	singleton
CASSQNSITRATNEKLFF	CASSQNSITRATNEKLFF	singleton
CASSPWTGNNEQFF	CASSPWTGNNEQFF	singleton
CSAPGLAGGLGDTQYF	CSAPGLAGGLGDTQYF	singleton
CASRTDPYGYTF	CASRTDPYGYTF	singleton
CASSMSARTGSNQPQHF	CASSMSARTGSNQPQHF	singleton
CASSPAGLSTDTQYF	CASSPAGLSTDTQYF	singleton
CSARSLAGGEADTQYF	CSARSLAGGEADTQYF	singleton
CASSPLGSLTDTQYF	CASSPLGSLTDTQYF	singleton
CAWARTGINQPQHF	CAWARTGINQPQHF	singleton
CASSLGGTRQYNEQFF	CASSLGGTRQYNEQFF	singleton
CASSLALGAWYEQYF	CASSLALGAWYEQYF	singleton
CASSSTRAGTGELFF	CASSSTRAGTGELFF	singleton
CASSQTTSQGELFF	CASSQTTSQGELFF	singleton
CSVNRQGFDEQYF	CSVNRQGFDEQYF	singleton
CASSPDRVNEQFF	CASSPDRVNEQFF	singleton
CASRGETTEQYF	CASRGETTEQYF	singleton
CASSLTGPRFF	CASSLTGPRFF	singleton
CASSPTGTSGRDNEQFF	CASSPTGTSGRDNEQFF	singleton
CASSMYGRVTDTQYF	CASSMYGRVTDTQYF	singleton
CSVAVGTNTEAFF	CSVAVGTNTEAFF	singleton
CASTGTGVTEAFF	CASTGTGVTEAFF	singleton
CASSYSGTGFNSPLHF	CASSYSGTGFNSPLHF	singleton
CASSYERGVVGDF	CASSYERGVVGDF	singleton
CASSPQGRGVSYNEQFF	CASSPQGRGVSYNEQFF	singleton
CATADRPNYGYTF	CATADRPNYGYTF	singleton
CATSRAGGREGYEQYF	CATSRAGGREGYEQYF	singleton
CSARDSGHYGYTF	CSARDSGHYGYTF	singleton
CASSQVLEGRNEQFF	CASSQVLEGRNEQFF	singleton
CAISDRRGEKLFF	CAISDRRGEKLFF	singleton
CASSQESVPYYGYTF	CASSQESVPYYGYTF	singleton
CASRLVQETGELFF	CASRLVQETGELFF	singleton
CASPRGGTTNEQFF	CASPRGGTTNEQFF	singleton
CASIDRGSEAFF	CASIDRGSEAFF	singleton
CSARRGFSGANVLTF	CSARRGFSGANVLTF	singleton
CASSLQADPNQPQHF	CASSLQADPNQPQHF	singleton
CAISESGTSGIRSYEQYF	CAISESGTSGIRSYEQYF	singleton
CASSKNRGSGAGANVLTF	CASSKNRGSGAGANVLTF	singleton
CASSTGGGVGYTF	CASSTGGGVGYTF	singleton
CAWKAGQADNSPLHF	CAWKAGQADNSPLHF	singleton
CASSSSRSEQFF	CASSSSRSEQFF	singleton
CASSDARPCEQYF	CASSDARPCEQYF	singleton
CATASGRNSYNEQFF	CATASGRNSYNEQFF	singleton
CASSLDGGPTYEQYF	CASSLDGGPTYEQYF	singleton
CAWSQQGESLHF	CAWSQQGESLHF	singleton
CASSPRDISYNEQFF	CASSPRDISYNEQFF	singleton
CASSPGIRANTEAFF	CASSPGIRANTEAFF	singleton
CSASDGGTNNSPLHF	CSASDGGTNNSPLHF	singleton
CASSQVAGVRTGELFF	CASSQVAGVRTGELFF	singleton
CASSGTGTVNTGELFF	CASSGTGTVNTGELFF	singleton
CASSLFPTTNEKLFF	CASSLFPTTNEKLFF	singleton
CASSPSSQGSYEQYF	CASSPSSQGSYEQYF	singleton
CASGDREPNQPQHF	CASGDREPNQPQHF	singleton
CASSLSSEFSYNEQFF	CASSLSSEFSYNEQFF	singleton
CASSPDAGGAYGYTF	CASSPDAGGAYGYTF	singleton
CSVEGRAKNIQYF	CSVEGRAKNIQYF	singleton
CASSPGGGSYNEQFF	CASSPGGGSYNEQFF	singleton
CASSQDRDRAPYGYTF	CASSQDRDRAPYGYTF	singleton
CASSLPGAKAGELFF	CASSLPGAKAGELFF	singleton
CASSLDRIYGYTF	CASSLDRIYGYTF	singleton
CSAPWTGVHEQYF	CSAPWTGVHEQYF	singleton
CATSVQGGNTIYF	CATSVQGGNTIYF	singleton
CASSQGREGYQPQHF	CASSQGREGYQPQHF	singleton
CSARATRNTEAFF	CSARATRNTEAFF	singleton
CASSSSGVGDEKLFF	CASSSSGVGDEKLFF	singleton
CASSEMDRDNSPLHF	CASSEMDRDNSPLHF	singleton
CASSPQAQVRNEQYF	CASSPQAQVRNEQYF	singleton
CASSLVGTGESFTF	CASSLVGTGESFTF	singleton
CAISGFGEATDTQYF	CAISGFGEATDTQYF	singleton
CASSGEGQPLHF	CASSGEGQPLHF	singleton
CASSVDREDRYTF	CASSVDREDRYTF	singleton
CASSLSGGTEAFF	CASSLSGGTEAFF	singleton
CASILGGPRYEQYF	CASILGGPRYEQYF	singleton
CSARRAPNQPQHF	CSARRAPNQPQHF	singleton
CASSGSPAGGELFF	CASSGSPAGGELFF	singleton
CASSLREGVGYTF	CASSLREGVGYTF	singleton
CASSKGLAGGRYEQYF	CASSKGLAGGRYEQYF	singleton
CASSSGAATYEQYF	CASSSGAATYEQYF	singleton
CASSRPPTVDGNTIYF	CASSRPPTVDGNTIYF	singleton
CASSPIGTAQYF	CASSPIGTAQYF	singleton
CASSSDGGRTEAFF	CASSSDGGRTEAFF	singleton
CASSLDKGRFMEAFF	CASSLDKGRFMEAFF	singleton
CASSEAQSYEQYF	CASSEAQSYEQYF	singleton
CASSLEGGIHEQYF	CASSLEGGIHEQYF	singleton
CSARTQRLAGRGEQYF	CSARTQRLAGRGEQYF	singleton
CASSLLGGTYNEQFF	CASSLLGGTYNEQFF	singleton
CSARDVQSRNSPLHF	CSARDVQSRNSPLHF	singleton
CASRPSIGPTETQYF	CASRPSIGPTETQYF	singleton
CASSPTTGRNEKLFF	CASSPTTGRNEKLFF	singleton
CASSLDGDYGYTF	CASSLDGDYGYTF	singleton
CASSQEGKANYGYTF	CASSQEGKANYGYTF	singleton
CASSWTGGKGEAFF	CASSWTGGKGEAFF	singleton
CASSPPMYTGGDTEAFF	CASSPPMYTGGDTEAFF	singleton
CASSSGVGAGETQYF	CASSSGVGAGETQYF	singleton
CASSYSRLNTEAFF	CASSYSRLNTEAFF	singleton
CASSFWQPNSPLHF	CASSFWQPNSPLHF	singleton
CSVVTGQAFF	CSVVTGQAFF	singleton
CASSLLGGSEKLFF	CASSLLGGSEKLFF	singleton
CASSLLFHISGKNIQYF	CASSLLFHISGKNIQYF	singleton
CASSRPGQGSGLHGYTF	CASSRPGQGSGLHGYTF	singleton
CASSPLGLAGELFF	CASSPLGLAGELFF	singleton
CASSQVGSHTEAFF	CASSQVGSHTEAFF	singleton
CASSFGTVNNEQFF	CASSFGTVNNEQFF	singleton
CASKRQGIGEAFF	CASKRQGIGEAFF	singleton
CASSAGRGSGGYTF	CASSAGRGSGGYTF	singleton
CASSGSGEAIYEQYF	CASSGSGEAIYEQYF	singleton
CASSYEESGELFF	CASSYEESGELFF	singleton
CASTTDRFRAEAFF	CASTTDRFRAEAFF	singleton
CASKTGNTNYGYTF	CASKTGNTNYGYTF	singleton
CASSRRQVKWEHEQFF	CASSRRQVKWEHEQFF	singleton
CASSTYSGNTIYF	CASSTYSGNTIYF	singleton
CASRETGGGVEEQYF	CASRETGGGVEEQYF	singleton
CASSPRTGTYEQYF	CASSPRTGTYEQYF	singleton
CSARDQLAGTDTQYF	CSARDQLAGTDTQYF	singleton
CSAASQFTTYGYTF	CSAASQFTTYGYTF	singleton
CATSDASRREQFF	CATSDASRREQFF	singleton
CASSRPDRVTDTQYF	CASSRPDRVTDTQYF	singleton
CAAVNQGTEAFF	CAAVNQGTEAFF	singleton
CASSPTLTAIANYGYTF	CASSPTLTAIANYGYTF	singleton
CASSYLGQGNGDEQFF	CASSYLGQGNGDEQFF	singleton
CASSHGQPGTGGVSEKLFF	CASSHGQPGTGGVSEKLFF	singleton
CASSTRQGQLFF	CASSTRQGQLFF	singleton
CASSPSGRNTEAFF	CASSPSGRNTEAFF	singleton
CASKPDNYGYTF	CASKPDNYGYTF	singleton
CTPRREEKLFF	CTPRREEKLFF	singleton
CATSDTTGLAGVGHNEQFF	CATSDTTGLAGVGHNEQFF	singleton
CASSSRSENTEAFF	CASSSRSENTEAFF	singleton
CASSREYRVPEQYF	CASSREYRVPEQYF	singleton
CASSLQGAKTQYF	CASSLQGAKTQYF	singleton
CASTLWTGGVGELFF	CASTLWTGGVGELFF	singleton
CASSPTSGGSDTQYF	CASSPTSGGSDTQYF	singleton
CSATTGTDGYTF	CSATTGTDGYTF	singleton
CASAGLGVDTQYF	CASAGLGVDTQYF	singleton
CASSFTTDTQYF	CASSFTTDTQYF	singleton
CASSRQGRHTGELFF	CASSRQGRHTGELFF	singleton
CASNAQGRHEQYF	CASNAQGRHEQYF	singleton
CASLPLGLESWGVGRTGELFF	CASLPLGLESWGVGRTGELFF	singleton
CASSLAGDSYNEQFF	CASSLAGDSYNEQFF	singleton
CATKRRGGGTDTQYF	CATKRRGGGTDTQYF	singleton
CASSTTSGIYEQYF	CASSTTSGIYEQYF	singleton
CASSYQGMRETQYF	CASSYQGMRETQYF	singleton
CSARGQPNQPQHF	CSARGQPNQPQHF	singleton
CASSLGGQGASRSYNSPLHF	CASSLGGQGASRSYNSPLHF	singleton
CASGLDTVGPQHF	CASGLDTVGPQHF	singleton
CASSSARETQYF	CASSSARETQYF	singleton
CASSPFRGSYEQYF	CASSPFRGSYEQYF	singleton
CASSGGSSSTDTQYF	CASSGGSSSTDTQYF	singleton
CASSPHSTLAASSYNEQFF	CASSPHSTLAASSYNEQFF	singleton
CASRSGTSGGPTYEQYF	CASRSGTSGGPTYEQYF	singleton
CSARGQGSGYTF	CSARGQGSGYTF	singleton
CASSAGKGAGEQYF	CASSAGKGAGEQYF	singleton
CASSLQGGKETQYF	CASSLQGGKETQYF	singleton
CASSQVQGNPHEQYF	CASSQVQGNPHEQYF	singleton
CASTSWGRGTGELFF	CASTSWGRGTGELFF	singleton
CASSFGTSDSYEQYF	CASSFGTSDSYEQYF	singleton
CASSHGENTEAFF	CASSHGENTEAFF	singleton
CASSPAGQGVDEKLFF	CASSPAGQGVDEKLFF	singleton
CAIKKGRSGNTIYF	CAIKKGRSGNTIYF	singleton
CASSLGPAGYNSPLHF	CASSLGPAGYNSPLHF	singleton
CASSVDGELFF	CASSVDGELFF	singleton
CASSPFRAGEGEQYF	CASSPFRAGEGEQYF	singleton
CASSSDSTTEAFF	CASSSDSTTEAFF	singleton
CASSPNQGAANTEAFF	CASSPNQGAANTEAFF	singleton
CSASPAGGGYEQYF	CSASPAGGGYEQYF	singleton
CASRVAGGGYNEQFF	CASRVAGGGYNEQFF	singleton
CASSLTGWDSSSYEQYF	CASSLTGWDSSSYEQYF	singleton
CASSPQRVNYEQYF	CASSPQRVNYEQYF	singleton
CASAWLNEQFF	CASAWLNEQFF	singleton
CASSLAGGPIYEQYF	CASSLAGGPIYEQYF	singleton
CATLTFSEAFF	CATLTFSEAFF	singleton
CASSAREMPNEQFF	CASSAREMPNEQFF	singleton
CASSRRATLTDTQYF	CASSRRATLTDTQYF	singleton
CASRSTGALQFF	CASRSTGALQFF	singleton
CASSLDPQETQYF	CASSLDPQETQYF	singleton
CASSATGGMGEKLFF	CASSATGGMGEKLFF	singleton
CASSQDSSHNSPLHF	CASSQDSSHNSPLHF	singleton
CASLREPQETQYF	CASLREPQETQYF	singleton
CASSVALQETQYF	CASSVALQETQYF	singleton
CASSPLAASTDTQYF	CASSPLAASTDTQYF	singleton
CASSWDQVDGYTF	CASSWDQVDGYTF	singleton
CASSASRGGPAFF	CASSASRGGPAFF	singleton
CASSLQEGTYEQYF	CASSLQEGTYEQYF	singleton
CASSWAGNNQPQHF	CASSWAGNNQPQHF	singleton
CAWSFPEQGVTEAFF	CAWSFPEQGVTEAFF	singleton
CASSTGGVNEKLFF	CASSTGGVNEKLFF	singleton
CASRYGTSVYQETQYF	CASRYGTSVYQETQYF	singleton
CASSSSAYEQYF	CASSSSAYEQYF	singleton
CASSYRQGGNSGNTIYF	CASSYRQGGNSGNTIYF	singleton
CSARGVYYNEQFF	CSARGVYYNEQFF	singleton
CASSFGHEVGNEQFF	CASSFGHEVGNEQFF	singleton
CASRDWGSGDEQYF	CASRDWGSGDEQYF	singleton
CASSEALRGVRGYTF	CASSEALRGVRGYTF	singleton
CASSPKRGTDTQYF	CASSPKRGTDTQYF	singleton
CASREREGYGYTF	CASREREGYGYTF	singleton
CASSIRLYNEQFF	CASSIRLYNEQFF	singleton
CASTVASAYEQYF	CASTVASAYEQYF	singleton
CASSYQGTVSGANVLTF	CASSYQGTVSGANVLTF	singleton
CATSDVGQGQETQYF	CATSDVGQGQETQYF	singleton
CAITPGQNTEAFF	CAITPGQNTEAFF	singleton
CASSQDLGERGHF	CASSQDLGERGHF	singleton
CAWIFPGGHNEQFF	CAWIFPGGHNEQFF	singleton
CASSLFGGAADTQYF	CASSLFGGAADTQYF	singleton
CASSSRYRADSPLHF	CASSSRYRADSPLHF	singleton
CASSEGEIFSYEQYF	CASSEGEIFSYEQYF	singleton
CAWTRRTDTQYF	CAWTRRTDTQYF	singleton
CASSYIPGTEAFF	CASSYIPGTEAFF	singleton
CAWSVQGGGNTIYF	CAWSVQGGGNTIYF	singleton
CSARDLGAETQYF	CSARDLGAETQYF	singleton
CASSLLISYNEQFF	CASSLLISYNEQFF	singleton
CASSDGDPSPLHF	CASSDGDPSPLHF	singleton
CASSRAANYGYTF	CASSRAANYGYTF	singleton
CASSLVPNTGELFF	CASSLVPNTGELFF	singleton
CASRRRGDYNEQFF	CASRRRGDYNEQFF	singleton
CAWSLGISSGNTIYF	CAWSLGISSGNTIYF	singleton
CASSSDRYYGYTF	CASSSDRYYGYTF	singleton
CASSLGGTLVAFF	CASSLGGTLVAFF	singleton
CASSSGVRETQYF	CASSSGVRETQYF	singleton
CSAFGREETQYF	CSAFGREETQYF	singleton
CSGAQGANYGYTF	CSGAQGANYGYTF	singleton
CASSLSPDSYYGYTF	CASSLSPDSYYGYTF	singleton
CASGPTVYEQYF	CASGPTVYEQYF	singleton
CASSYQAGGEQYF	CASSYQAGGEQYF	singleton
CASSYPSGTVGQTEAFF	CASSYPSGTVGQTEAFF	singleton
CSGRRGGATNEKLFF	CSGRRGGATNEKLFF	singleton
CATSGQGGSEAFF	CATSGQGGSEAFF	singleton
CASSQDAGEAFF	CASSQDAGEAFF	singleton
CAISEIIATYTGELFF	CAISEIIATYTGELFF	singleton
CASSIRIGSGANVLTF	CASSIRIGSGANVLTF	singleton
CSARGVSSGGWSKTQYF	CSARGVSSGGWSKTQYF	singleton
CASSSGQGYGYTF	CASSSGQGYGYTF	singleton
CASSYHVLNSPLHF	CASSYHVLNSPLHF	singleton
CASSPTGSTEAFF	CASSPTGSTEAFF	singleton
CASSFSGLDEQYF	CASSFSGLDEQYF	singleton
CASSPLGGRSNTEAFF	CASSPLGGRSNTEAFF	singleton
CSGAGGFQETQYF	CSGAGGFQETQYF	singleton
CASSVAGSGGTDTQYF	CASSVAGSGGTDTQYF	singleton
CASSDAGTGLGGYTF	CASSDAGTGLGGYTF	singleton
CASSLGQVDTGELFF	CASSLGQVDTGELFF	singleton
CASSSTVQQTAQHF	CASSSTVQQTAQHF	singleton
CSAVNGRGRGAYEQYF	CSAVNGRGRGAYEQYF	singleton
CASSLSGLAGGDEQFF	CASSLSGLAGGDEQFF	singleton
CATSGATASKNNEQFF	CATSGATASKNNEQFF	singleton
CASSLGLAGGPYNEQFF	CASSLGLAGGPYNEQFF	singleton
CAWSVGQYEQYF	CAWSVGQYEQYF	singleton
CASSLRGRSYEQYF	CASSLRGRSYEQYF	singleton
CSAGPALDTQYF	CSAGPALDTQYF	singleton
CSVYGGRETYDTEAFF	CSVYGGRETYDTEAFF	singleton
CASSQIDRNTEAFF	CASSQIDRNTEAFF	singleton
CASSYHPGQGSWSNQPQHF	CASSYHPGQGSWSNQPQHF	singleton
CASSFGGDTQYF	CASSFGGDTQYF	singleton
CASSYWGDGYYEQYF	CASSYWGDGYYEQYF	singleton
CSARGRGTGGDYGYTF	CSARGRGTGGDYGYTF	singleton
CSVGFGSNTEAFF	CSVGFGSNTEAFF	singleton
CSAAPGLAVPGELFF	CSAAPGLAVPGELFF	singleton
CASSEEGRNSPLHF	CASSEEGRNSPLHF	singleton
CASSQGPAAVVFGTQYF	CASSQGPAAVVFGTQYF	singleton
CSARVPGGNNQPQHF	CSARVPGGNNQPQHF	singleton
CASSPYWAARRTDTQYF	CASSPYWAARRTDTQYF	singleton
CSVRAQPNTEAFF	CSVRAQPNTEAFF	singleton
CASSSREANTDTQYF	CASSSREANTDTQYF	singleton
CASSFGLAGGGNTQYF	CASSFGLAGGGNTQYF	singleton
CASRRAGAYTGELFF	CASRRAGAYTGELFF	singleton
CSARVSMNTEAFF	CSARVSMNTEAFF	singleton
CASSLRNGQPTEQFF	CASSLRNGQPTEQFF	singleton
CATALQGDYEQYF	CATALQGDYEQYF	singleton
CASSVPWGGREETQYF	CASSVPWGGREETQYF	singleton
CASSFSGGANEQYF	CASSFSGGANEQYF	singleton
CASSLAGTGITDTQYF	CASSLAGTGITDTQYF	singleton
CSAIYRGGASYNEQFF	CSAIYRGGASYNEQFF	singleton
CATSPGHSSQETQYF	CATSPGHSSQETQYF	singleton
CASSSTGSTDTQYF	CASSSTGSTDTQYF	singleton
CASSLLLNGEAFF	CASSLLLNGEAFF	singleton
CASSVTAKRTDTQYF	CASSVTAKRTDTQYF	singleton
CASSYDGTSGGATSVDTQYF	CASSYDGTSGGATSVDTQYF	singleton
CASSLQGIRNTEAFF	CASSLQGIRNTEAFF	singleton
CASSRDRGNQPQHF	CASSRDRGNQPQHF	singleton
CASSSSGTTPSEQYF	CASSSSGTTPSEQYF	singleton
CASSRQRQVGNTIYF	CASSRQRQVGNTIYF	singleton
CSAPRASGGRYEQYF	CSAPRASGGRYEQYF	singleton
CAWTLGSSYEQYF	CAWTLGSSYEQYF	singleton
CASSLDGASYEQYF	CASSLDGASYEQYF	singleton
CASSLAFLRSYEQYF	CASSLAFLRSYEQYF	singleton
CAWSLRRSSGTSGTDNEQFF	CAWSLRRSSGTSGTDNEQFF	singleton
CASSWPGIEDEQFF	CASSWPGIEDEQFF	singleton
CASSFSWEALPDTQYF	CASSFSWEALPDTQYF	singleton
CASGLGGGLVKNIQYF	CASGLGGGLVKNIQYF	singleton
CASRRETNTGELFF	CASRRETNTGELFF	singleton
CASSYTDNQPQHF	CASSYTDNQPQHF	singleton
CASSINAGVRNTEAFF	CASSINAGVRNTEAFF	singleton
CASSEYASNSPLHF	CASSEYASNSPLHF	singleton
CASSFWKDSYGYTF	CASSFWKDSYGYTF	singleton
CASSLVLLTYGKVYEQYF	CASSLVLLTYGKVYEQYF	singleton
CASSPGRDTDTQYF	CASSPGRDTDTQYF	singleton
CASRPGVDSPLHF	CASRPGVDSPLHF	singleton
CASSQDRRAGWGYGYTF	CASSQDRRAGWGYGYTF	singleton
CASSRTGTHTGELFF	CASSRTGTHTGELFF	singleton
CASSLFETGGLISTDTQYF	CASSLFETGGLISTDTQYF	singleton
CASSRAGGDTGELFF	CASSRAGGDTGELFF	singleton
CASSGTGGGGNQPQHF	CASSGTGGGGNQPQHF	singleton
CASSPRTSGNTDTQYF	CASSPRTSGNTDTQYF	singleton
CAISDPDSNTGELFF	CAISDPDSNTGELFF	singleton
CASSPPHLADSYNEQFF	CASSPPHLADSYNEQFF	singleton
CASTWDTKNIQYF	CASTWDTKNIQYF	singleton
CSAREVGRSGNTIYF	CSAREVGRSGNTIYF	singleton
CASNDRSYEQYF	CASNDRSYEQYF	singleton
CASSVGENSYEQYF	CASSVGENSYEQYF	singleton
CASSLAEFNGRRPYNEQFF	CASSLAEFNGRRPYNEQFF	singleton
CASSLAEGQYF	CASSLAEGQYF	singleton
CASSWTGGGGKTQYF	CASSWTGGGGKTQYF	singleton
CASSFLEAGSSPLHF	CASSFLEAGSSPLHF	singleton
CASSPDIGRGELFF	CASSPDIGRGELFF	singleton
CASSPLAGGRETQYF	CASSPLAGGRETQYF	singleton
CASSERDHEQYF	CASSERDHEQYF	singleton
CASSEPGDGSYEQYF	CASSEPGDGSYEQYF	singleton
CASSSGRRKEETQYF	CASSSGRRKEETQYF	singleton
CAISDLDMVDGSGNTIYF	CAISDLDMVDGSGNTIYF	singleton
CASSVGTTQETQYF	CASSVGTTQETQYF	singleton
CASSFPRRGVISYNEQFF	CASSFPRRGVISYNEQFF	singleton
CASSTNPGTSNEQYF	CASSTNPGTSNEQYF	singleton
CASSHRTKETQYF	CASSHRTKETQYF	singleton
CASSLIVGSGRETQYF	CASSLIVGSGRETQYF	singleton
CASSLVDQDNEQFF	CASSLVDQDNEQFF	singleton
CASSPPRTGVTEAFF	CASSPPRTGVTEAFF	singleton
CATKERSNQPQHF	CATKERSNQPQHF	singleton
CASSLGGRTTGELFF	CASSLGGRTTGELFF	singleton
CASRRSGAETTNGYTF	CASRRSGAETTNGYTF	singleton
CASSFGEKLFF	CASSFGEKLFF	singleton
CASSLGGAGGAFF	CASSLGGAGGAFF	singleton
CASSPNFGRAETQYF	CASSPNFGRAETQYF	singleton
CAISGRRDRALHEDTQYF	CAISGRRDRALHEDTQYF	singleton
CASSLGGGADTQYF	CASSLGGGADTQYF	singleton
CASSLDVPETYTYEQYF	CASSLDVPETYTYEQYF	singleton
CASSPGLAGTWGEQFF	CASSPGLAGTWGEQFF	singleton
CASSDQGDSYEQYF	CASSDQGDSYEQYF	singleton
CSALGTQGHQPQHF	CSALGTQGHQPQHF	singleton
CASSLGQGEYSPLHF	CASSLGQGEYSPLHF	singleton
CASSPLRTDQETQYF	CASSPLRTDQETQYF	singleton
CSASEGGEGNEQFF	CSASEGGEGNEQFF	singleton
CASSNRAGSGYNEQFF	CASSNRAGSGYNEQFF	singleton
CASSQDPARPNPDTQYF	CASSQDPARPNPDTQYF	singleton
CSVHGSGEETQYF	CSVHGSGEETQYF	singleton
CASSLGTSGGAREQFF	CASSLGTSGGAREQFF	singleton
CASSIDLTGHHTQYF	CASSIDLTGHHTQYF	singleton
CASSPRAQRGGSDTQYF	CASSPRAQRGGSDTQYF	singleton
CAWSVTGSGNTIYF	CAWSVTGSGNTIYF	singleton
CASSRWDSNNEQFF	CASSRWDSNNEQFF	singleton
CASSFYRGGGNTEAFF	CASSFYRGGGNTEAFF	singleton
CASSQWVTGNTIYF	CASSQWVTGNTIYF	singleton
CASSSWGGGYTF	CASSSWGGGYTF	singleton
CASSGRTGELFF	CASSGRTGELFF	singleton
CASRRTGVDYEQYF	CASRRTGVDYEQYF	singleton
CASSLGKGGGGYSPLHF	CASSLGKGGGGYSPLHF	singleton
CASSRGQNNEKLFF	CASSRGQNNEKLFF	singleton
CASSAGYSSGNTIYF	CASSAGYSSGNTIYF	singleton
CASSLDPGGRQYF	CASSLDPGGRQYF	singleton
CSAQQPGPATRVQYF	CSAQQPGPATRVQYF	singleton
CASSDFSGAYNEQFF	CASSDFSGAYNEQFF	singleton
CASSQGFRDWGETQYF	CASSQGFRDWGETQYF	singleton
CSARDLPGLAVGGAGELFF	CSARDLPGLAVGGAGELFF	singleton
CASRPGRMDEQFF	CASRPGRMDEQFF	singleton
CAWSASGELFF	CAWSASGELFF	singleton
CASSSHNTEAFF	CASSSHNTEAFF	singleton
CASSYIAGGRNEQFF	CASSYIAGGRNEQFF	singleton
CASSYTSNNYGYTF	CASSYTSNNYGYTF	singleton
CATGAGETQYF	CATGAGETQYF	singleton
CASSSGSGNTIYF	CASSSGSGNTIYF	singleton
CASSVGTPFPYEQYF	CASSVGTPFPYEQYF	singleton
CASSLTGGGVLETQYF	CASSLTGGGVLETQYF	singleton
CASSLESGTGSLEQYF	CASSLESGTGSLEQYF	singleton
CASSLDLPPALHF	CASSLDLPPALHF	singleton
CASSQEGTEAFF	CASSQEGTEAFF	singleton
CASSSARGRFDTEAFF	CASSSARGRFDTEAFF	singleton
CASSLAGGYEQYF	CASSLAGGYEQYF	singleton
CASVYGSTLTEAFF	CASVYGSTLTEAFF	singleton
CASSSLARAGDTQYF	CASSSLARAGDTQYF	singleton
CSAQRQGRSGANVLTF	CSAQRQGRSGANVLTF	singleton
CASSQLGVGEAFF	CASSQLGVGEAFF	singleton
CSVRQGHNEQFF	CSVRQGHNEQFF	singleton
CASSYGARVETQYF	CASSYGARVETQYF	singleton
CASSFDLGQFF	CASSFDLGQFF	singleton
CASSSPSGRGETQYF	CASSSPSGRGETQYF	singleton
CATSDRDRGEQYF	CATSDRDRGEQYF	singleton
CASSPPGTRGEQYF	CASSPPGTRGEQYF	singleton
CASSATSGSANEQFF	CASSATSGSANEQFF	singleton
CASSPRGGLTYEQYF	CASSPRGGLTYEQYF	singleton
CASSQPGGTEKLFF	CASSQPGGTEKLFF	singleton
CASSLQGARYEQYF	CASSLQGARYEQYF	singleton
CASSLYSSGTEAFF	CASSLYSSGTEAFF	singleton
CASSLLGDTQYF	CASSLLGDTQYF	singleton
CASSSPFRGLYEQYF	CASSSPFRGLYEQYF	singleton
CASSPGGGTGTEQYF	CASSPGGGTGTEQYF	singleton
CACNKGDSYEQYF	CACNKGDSYEQYF	singleton
CASSSRIGSGNTIYF	CASSSRIGSGNTIYF	singleton
CASSPATLNYEQYF	CASSPATLNYEQYF	singleton
CASSPGPLGQGKATNEKLFF	CASSPGPLGQGKATNEKLFF	singleton
CASSSNRAGANVLTF	CASSSNRAGANVLTF	singleton
CASSQEGAWTGELFF	CASSQEGAWTGELFF	singleton
CASSQSDRRTDTQYF	CASSQSDRRTDTQYF	singleton
CASSEEGNPGETQYF	CASSEEGNPGETQYF	singleton
CASRTAENTEAFF	CASRTAENTEAFF	singleton
CASSLRRGAIQETQYF	CASSLRRGAIQETQYF	singleton
CATSDGGAETQYF	CATSDGGAETQYF	singleton
CASSFYRALGDTQYF	CASSFYRALGDTQYF	singleton
CSARGDSGGGAREAFF	CSARGDSGGGAREAFF	singleton
CASSQARQGEQYF	CASSQARQGEQYF	singleton
CASSKQGNQGQPQHF	CASSKQGNQGQPQHF	singleton
CASSLTGTGGHEQFF	CASSLTGTGGHEQFF	singleton
CASTYTLSTDTQYF	CASTYTLSTDTQYF	singleton
CASGLGGQVQNYGYTF	CASGLGGQVQNYGYTF	singleton
CASTRAANSPLHF	CASTRAANSPLHF	singleton
CASSKLGQGEGEQFF	CASSKLGQGEGEQFF	singleton
CASGASTEAFF	CASGASTEAFF	singleton
CASSFSGNTEAFF	CASSFSGNTEAFF	singleton
CASGLGENIQYF	CASGLGENIQYF	singleton
CATSDTLMGAWNEQFF	CATSDTLMGAWNEQFF	singleton
CASSVYRGSTEAFF	CASSVYRGSTEAFF	singleton
CASSFRSGGAYEQYF	CASSFRSGGAYEQYF	singleton
CASSPLGRQAGANVLTF	CASSPLGRQAGANVLTF	singleton
CASSPGTSGYEQYF	CASSPGTSGYEQYF	singleton
CASSPPGTGGHEQFF	CASSPPGTGGHEQFF	singleton
CASSNRSGTGNEKLFF	CASSNRSGTGNEKLFF	singleton
CASSKQGNTGELFF	CASSKQGNTGELFF	singleton
CASSPGTSDYNEQFF	CASSPGTSDYNEQFF	singleton
CASSDGSSSYNEQFF	CASSDGSSSYNEQFF	singleton
CASSPQGTGSYTGELFF	CASSPQGTGSYTGELFF	singleton
CASNTGGRETQYF	CASNTGGRETQYF	singleton
CASRGGSYGYTF	CASRGGSYGYTF	singleton
CASSDRGQGAFF	CASSDRGQGAFF	singleton
CATKSDDRGTEAFF	CATKSDDRGTEAFF	singleton
CASTPGGITVSYNEQFF	CASTPGGITVSYNEQFF	singleton
CSARGPRQGTNTEAFF	CSARGPRQGTNTEAFF	singleton
CASSSLGAGGHNEQFF	CASSSLGAGGHNEQFF	singleton
CATQDTYEQYF	CATQDTYEQYF	singleton
CSPLGARVMNTEAFF	CSPLGARVMNTEAFF	singleton
CASSLGQGPRGNEQFF	CASSLGQGPRGNEQFF	singleton
CASSLSPLNTEAFF	CASSLSPLNTEAFF	singleton
CASGSGTDTQYF	CASGSGTDTQYF	singleton
CASSLMSGVIGEQYF	CASSLMSGVIGEQYF	singleton
CASRSLSASRGEQYF	CASRSLSASRGEQYF	singleton
CASSPGRAANYGYTF	CASSPGRAANYGYTF	singleton
CASSQESAAGPSYEQYF	CASSQESAAGPSYEQYF	singleton
CSARDPAGGVVNEQFF	CSARDPAGGVVNEQFF	singleton
CSARTSGRTGANVLTF	CSARTSGRTGANVLTF	singleton
CASRTGTSGKTQYF	CASRTGTSGKTQYF	singleton
CASSSIGWSSYNEQFF	CASSSIGWSSYNEQFF	singleton
CASTGITGARSGELFF	CASTGITGARSGELFF	singleton
CASSLGRGGSTEAFF	CASSLGRGGSTEAFF	singleton
CASSLVKGYEQYF	CASSLVKGYEQYF	singleton
CASSLAIQENTEAFF	CASSLAIQENTEAFF	singleton
CASSYGQAYEQYF	CASSYGQAYEQYF	singleton
CASSLSSEVYYNEQFF	CASSLSSEVYYNEQFF	singleton
CASSPIDGYEKLFF	CASSPIDGYEKLFF	singleton
CSASGGGEKLFF	CSASGGGEKLFF	singleton
CASSYSTSGNTGELFF	CASSYSTSGNTGELFF	singleton
CASAASQETQYF	CASAASQETQYF	singleton
CASSFWNSYGYTF	CASSFWNSYGYTF	singleton
CASSYSTGGSYEQYF	CASSYSTGGSYEQYF	singleton
CASVRELAYGYTF	CASVRELAYGYTF	singleton
CASTTHGDRARDEQFF	CASTTHGDRARDEQFF	singleton
CASSLHGGNSPLHF	CASSLHGGNSPLHF	singleton
CASSLWNTDTQYF	CASSLWNTDTQYF	singleton
CASSLVPTSGTGELFF	CASSLVPTSGTGELFF	singleton
CASSSPGQGNHEQYF	CASSSPGQGNHEQYF	singleton
CASSLLGSYEQYF	CASSLLGSYEQYF	singleton
CASSYGTSGGHETQYF	CASSYGTSGGHETQYF	singleton
CASSVRGGYTDTQYF	CASSVRGGYTDTQYF	singleton
CASSEWRGNEQFF	CASSEWRGNEQFF	singleton
CASSPDGSSGNTIYF	CASSPDGSSGNTIYF	singleton
CAWAGTGGSPLHF	CAWAGTGGSPLHF	singleton
CASSHGEKPQHF	CASSHGEKPQHF	singleton
CAWSDPGLTGNSPLHF	CAWSDPGLTGNSPLHF	singleton
CSASPPGLAGPDTQYF	CSASPPGLAGPDTQYF	singleton
CASSPGPGGTGELFF	CASSPGPGGTGELFF	singleton
CASSLLQGSYEQYF	CASSLLQGSYEQYF	singleton
CASSQRSYEQYF	CASSQRSYEQYF	singleton
CASSQDRGWGQGARYEQFF	CASSQDRGWGQGARYEQFF	singleton
CASGLVQGVTDTQYF	CASGLVQGVTDTQYF	singleton
CASSSGTTGYEQYF	CASSSGTTGYEQYF	singleton
CASSQGRGSPYEQYF	CASSQGRGSPYEQYF	singleton
CASSPRREFTGNTIYF	CASSPRREFTGNTIYF	singleton
CAWSAANTEAFF	CAWSAANTEAFF	singleton
CASSQDRASGYTF	CASSQDRASGYTF	singleton
CASSLAQLQNIQYF	CASSLAQLQNIQYF	singleton
CASSLVGGNGYTF	CASSLVGGNGYTF	singleton
CASSPGQGSSYNSPLHF	CASSPGQGSSYNSPLHF	singleton
CSASAGVGDTQYF	CSASAGVGDTQYF	singleton
CSARGTPYSPLHF	CSARGTPYSPLHF	singleton
CASSSITGGTDTQYF	CASSSITGGTDTQYF	singleton
CSAAADSHTGELFF	CSAAADSHTGELFF	singleton
CSAVPDSNTDTQYF	CSAVPDSNTDTQYF	singleton
CASSPMTVGYTF	CASSPMTVGYTF	singleton
CAWSVLGIYGYTF	CAWSVLGIYGYTF	singleton
CASSPRAGDEQFF	CASSPRAGDEQFF	singleton
CASSRSRDFQETQYF	CASSRSRDFQETQYF	singleton
CASSDWTSGSNIQYF	CASSDWTSGSNIQYF	singleton
CASSWDRGRTGELFF	CASSWDRGRTGELFF	singleton
CSARSQGASEQYF	CSARSQGASEQYF	singleton
CASSPGDLGNTIYF	CASSPGDLGNTIYF	singleton
CSATANTGELFF	CSATANTGELFF	singleton
CASSYSRSLNQPQHF	CASSYSRSLNQPQHF	singleton
CASSLEGAGNTIYF	CASSLEGAGNTIYF	singleton
CATSRGGTEETQYF	CATSRGGTEETQYF	singleton
CASSPQSSLMSSYEQYF	CASSPQSSLMSSYEQYF	singleton
CSAPNRGASSEQFF	CSAPNRGASSEQFF	singleton
CASSLLPGLGTDTQYF	CASSLLPGLGTDTQYF	singleton
CASSAQGIGDTQYF	CASSAQGIGDTQYF	singleton
CSASSDRGPDTEAFF	CSASSDRGPDTEAFF	singleton
CASSAGRTGGSYGYTF	CASSAGRTGGSYGYTF	singleton
CSASGAGELFF	CSASGAGELFF	singleton
CASSPFPTGELFF	CASSPFPTGELFF	singleton
CASAAAGGLDTQYF	CASAAAGGLDTQYF	singleton
CASSYSPTAEQFF	CASSYSPTAEQFF	singleton
CASSSKLTGGNSPLHF	CASSSKLTGGNSPLHF	singleton
CASSLTGSQETQYF	CASSLTGSQETQYF	singleton
CASSHRTGSTDTQYF	CASSHRTGSTDTQYF	singleton
CASSSDSNSPLHF	CASSSDSNSPLHF	singleton
CASFGGGSYEQYF	CASFGGGSYEQYF	singleton
CASRKAGPKNTGELFF	CASRKAGPKNTGELFF	singleton
CAWSVGLAKNIQYF	CAWSVGLAKNIQYF	singleton
CASSEQGYNEQFF	CASSEQGYNEQFF	singleton
CASSLRLAAYTEQFF	CASSLRLAAYTEQFF	singleton
CSAPLGGSRINEQYF	CSAPLGGSRINEQYF	singleton
CASSSRDRGLQETQYF	CASSSRDRGLQETQYF	singleton
CASKGRGLNEQFF	CASKGRGLNEQFF	singleton
CASSFSQSEQFF	CASSFSQSEQFF	singleton
CASSLHRGGNSPLHF	CASSLHRGGNSPLHF	singleton
CASSYSPGGSSYEQYF	CASSYSPGGSSYEQYF	singleton
CASSFWDRGEQYF	CASSFWDRGEQYF	singleton
CASTQWASGGERSYNEQFF	CASTQWASGGERSYNEQFF	singleton
CSAMDSGTGGSYGYTF	CSAMDSGTGGSYGYTF	singleton
CASSQTDEAFF	CASSQTDEAFF	singleton
CASSKNTGELFF	CASSKNTGELFF	singleton
CSARDMGRPNTGELFF	CSARDMGRPNTGELFF	singleton
CASKDLETQYF	CASKDLETQYF	singleton
CASKRGQASNSPLHF	CASKRGQASNSPLHF	singleton
CAIQNVSGRGKNIQYF	CAIQNVSGRGKNIQYF	singleton
CASSRQGRDEQYF	CASSRQGRDEQYF	singleton
CAISEGTGGLEKLFF	CAISEGTGGLEKLFF	singleton
CASSSTLAPLHF	CASSSTLAPLHF	singleton
CASSTKGGGTEAFF	CASSTKGGGTEAFF	singleton
CASSQDRDYGYTF	CASSQDRDYGYTF	singleton
CVSSLSGILTGELFF	CVSSLSGILTGELFF	singleton
CASSLSPGQNNSPLHF	CASSLSPGQNNSPLHF	singleton
CASSQDLSAGTEAFF	CASSQDLSAGTEAFF	singleton
CASSFSVGSRNTIYF	CASSFSVGSRNTIYF	singleton
CASREDRSNQPQHF	CASREDRSNQPQHF	singleton
CASSSGTGNTGELFF	CASSSGTGNTGELFF	singleton
CASSLTIGGRGQYNEQFF	CASSLTIGGRGQYNEQFF	singleton
CAWSPDRGRWDSGKLFF	CAWSPDRGRWDSGKLFF	singleton
CSARGSGLNTDTQYF	CSARGSGLNTDTQYF	singleton
CASSSHRAEQYF	CASSSHRAEQYF	singleton
CASSPLHNEQFF	CASSPLHNEQFF	singleton
CASSQETGELFF	CASSQETGELFF	singleton
CASSPQGDGNQPQHF	CASSPQGDGNQPQHF	singleton
CSASPPYQPQHF	CSASPPYQPQHF	singleton
CASSQGGKTQYF	CASSQGGKTQYF	singleton
CASSVGGGFEQYF	CASSVGGGFEQYF	singleton
CASSSIRHTEAFF	CASSSIRHTEAFF	singleton
CAIKGDGDTEAFF	CAIKGDGDTEAFF	singleton
CASSPLTRGMDNEQFF	CASSPLTRGMDNEQFF	singleton
CASSYTDSPNTEAFF	CASSYTDSPNTEAFF	singleton
CASSFWTGGVKNTGELFF	CASSFWTGGVKNTGELFF	singleton
CASSLVAGGSMTGELFF	CASSLVAGGSMTGELFF	singleton
CASSLGQGTNEKLFF	CASSLGQGTNEKLFF	singleton
CASTGLAGDTGELFF	CASTGLAGDTGELFF	singleton
CASSQDASGTYNEQFF	CASSQDASGTYNEQFF	singleton
CASLYGPERQFF	CASLYGPERQFF	singleton
CASSGSGGAGGANVLTF	CASSGSGGAGGANVLTF	singleton
CASSYGTGTAGLMDGYTF	CASSYGTGTAGLMDGYTF	singleton
CASSERLAEDNEQFF	CASSERLAEDNEQFF	singleton
CSARSSTPSFDTQYF	CSARSSTPSFDTQYF	singleton
CASSLLRGETQYF	CASSLLRGETQYF	singleton
CASTLTSGGLETQYF	CASTLTSGGLETQYF	singleton
CASSDREVRNSPLHF	CASSDREVRNSPLHF	singleton
CASSLDGQGYSPLHF	CASSLDGQGYSPLHF	singleton
CASSDSRGSPLHF	CASSDSRGSPLHF	singleton
CAWLGAADTKDIGDTQYF	CAWLGAADTKDIGDTQYF	singleton
CAWSGTAGEKLFF	CAWSGTAGEKLFF	singleton
CASSFGGGSGSAFF	CASSFGGGSGSAFF	singleton
CASTRLAGVGNEQFF	CASTRLAGVGNEQFF	singleton
CASTRDRGFTDTQYF	CASTRDRGFTDTQYF	singleton
CASSYSTALPNQPQHF	CASSYSTALPNQPQHF	singleton
